fips,county,state,lat,long,male,female,population
1001,Autauga ,Alabama,32.53492293,-86.64273014,26874,28326,55200
1003,Baldwin ,Alabama,30.72747877,-87.72256353,101188,106919,208107
1005,Barbour ,Alabama,31.86958144,-85.39320979,13697,12085,25782
1007,Bibb ,Alabama,32.99862823,-87.12647507,12152,10375,22527
1009,Blount ,Alabama,33.98086883,-86.5673804,28434,29211,57645
1011,Bullock ,Alabama,32.10052546,-85.71567933,5663,4689,10352
1013,Butler ,Alabama,31.75242916,-86.68027562,9368,10657,20025
1015,Calhoun ,Alabama,33.77141566,-85.82603922,55315,59783,115098
1017,Chambers ,Alabama,32.91434535,-85.39203022,16257,17569,33826
1019,Cherokee ,Alabama,34.17590465,-85.60380096,12820,13033,25853
1021,Chilton ,Alabama,32.84786731,-86.71879022,21672,22258,43930
1023,Choctaw ,Alabama,32.01977172,-88.26317981,6253,6822,13075
1025,Clarke ,Alabama,31.67667781,-87.83080862,11539,12848,24387
1027,Clay ,Alabama,33.2690236,-85.86057902,6464,6914,13378
1029,Cleburne ,Alabama,33.6745132,-85.51880933,7281,7657,14938
1031,Coffee ,Alabama,31.40264942,-85.98815268,25314,25974,51288
1033,Colbert ,Alabama,34.70047094,-87.80492781,26075,28420,54495
1035,Conecuh ,Alabama,31.42923693,-86.99366151,6037,6477,12514
1037,Coosa ,Alabama,32.93624304,-86.2476616,5501,5354,10855
1039,Covington ,Alabama,31.24849145,-86.45126684,18172,19179,37351
1041,Crenshaw ,Alabama,31.7315185,-86.31354751,6814,7051,13865
1043,Cullman ,Alabama,34.13194523,-86.86757572,40560,41753,82313
1045,Dale ,Alabama,31.43181019,-85.61100443,24234,25021,49255
1047,Dallas ,Alabama,32.32597926,-87.106469,18448,21581,40029
1049,DeKalb ,Alabama,34.45980033,-85.80410977,35304,35896,71200
1051,Elmore ,Alabama,32.5966475,-86.14915716,39450,41762,81212
1053,Escambia ,Alabama,31.12613475,-87.16158196,19067,18261,37328
1055,Etowah ,Alabama,34.04525667,-86.03476333,49651,53288,102939
1057,Fayette ,Alabama,33.72122226,-87.73885771,8170,8415,16585
1059,Franklin ,Alabama,34.4416923,-87.84373463,15602,15940,31542
1061,Geneva ,Alabama,31.09505485,-85.83909145,12971,13520,26491
1063,Greene ,Alabama,32.85314776,-87.95220353,3950,4476,8426
1065,Hale ,Alabama,32.76266346,-87.62914937,7019,7868,14887
1067,Henry ,Alabama,31.5147053,-85.24141341,8232,8892,17124
1069,Houston ,Alabama,31.15320088,-85.30247404,50029,54323,104352
1071,Jackson ,Alabama,34.77945558,-85.99935398,25536,26558,52094
1073,Jefferson ,Alabama,33.5543345,-86.89640831,312348,347544,659892
1075,Lamar ,Alabama,33.77913539,-88.09695813,6800,7133,13933
1077,Lauderdale ,Alabama,34.90140733,-87.65400965,44315,48270,92585
1079,Lawrence ,Alabama,34.52167796,-87.31099056,16003,17168,33171
1081,Lee ,Alabama,32.60113565,-85.35547859,78372,80915,159287
1083,Limestone ,Alabama,34.81010128,-86.98140593,46427,46625,93052
1085,Lowndes ,Alabama,32.1547457,-86.65010823,4830,5406,10236
1087,Macon ,Alabama,32.38593866,-85.6926558,8790,10264,19054
1089,Madison ,Alabama,34.76309047,-86.55022472,174665,182895,357560
1091,Marengo ,Alabama,32.24766549,-87.78953082,9446,10092,19538
1093,Marion ,Alabama,34.13655552,-87.88713525,14898,15067,29965
1095,Marshall ,Alabama,34.3669525,-86.30662785,46977,48168,95145
1097,Mobile ,Alabama,30.7872122,-88.20579886,197928,216731,414659
1099,Monroe ,Alabama,31.57087542,-87.36543633,10230,11282,21512
1101,Montgomery ,Alabama,32.2202638,-86.20761817,107354,119587,226941
1103,Morgan ,Alabama,34.45346831,-86.85292483,58660,60462,119122
1105,Perry ,Alabama,32.63846919,-87.29440144,4436,5050,9486
1107,Pickens ,Alabama,33.28079282,-88.08875081,9708,10590,20298
1109,Pike ,Alabama,31.80272314,-85.94091891,16027,17376,33403
1111,Randolph ,Alabama,33.29378477,-85.45912879,10989,11585,22574
1113,Russell ,Alabama,32.28839324,-85.18492487,28124,30089,58213
1115,St. Clair ,Alabama,33.71571864,-86.31461907,43755,43551,87306
1117,Shelby ,Alabama,33.2642776,-86.66066541,102478,108783,211261
1119,Sumter ,Alabama,32.59105735,-88.19884604,6014,6971,12985
1121,Talladega ,Alabama,33.38007938,-86.16588537,39156,41409,80565
1123,Tallapoosa ,Alabama,32.86235062,-85.79750899,19517,21119,40636
1125,Tuscaloosa ,Alabama,33.28956942,-87.52510915,99539,106674,206213
1127,Walker ,Alabama,33.80331124,-87.29732387,31506,32987,64493
1129,Washington ,Alabama,31.40762895,-88.20785731,8420,8223,16643
1131,Wilcox ,Alabama,31.98929675,-87.30819033,5134,5675,10809
1133,Winston ,Alabama,34.14919948,-87.37366307,11840,12035,23875
2013,Aleutians East Borough,Alaska,55.36650712,-161.9813303,1989,1436,3425
2016,Aleutians West Census Area,Alaska,52.79799632,-106.60606,3432,2318,5750
2020,Anchorage Municipality,Alaska,61.1508253,-149.1091175,151144,144968,296112
2050,Bethel Census Area,Alaska,60.9132308,-159.8180174,9381,8659,18040
2060,Bristol Bay Borough,Alaska,58.74386361,-156.6999775,526,364,890
2068,Denali Borough,Alaska,63.67164251,-150.0117159,1117,1115,2232
2070,Dillingham Census Area,Alaska,59.79906654,-158.2350895,2573,2402,4975
2090,Fairbanks North Star Borough,Alaska,64.80776533,-146.5654114,53846,45807,99653
2100,Haines Borough,Alaska,59.11987925,-135.4999528,1335,1183,2518
2105,Hoonah-Angoon Census Area,Alaska,58.28835669,-135.6429933,1095,1037,2132
2110,Juneau City and Borough,Alaska,58.45463055,-134.1739418,16517,15813,32330
2122,Kenai Peninsula Borough,Alaska,60.26541332,-151.5652439,30314,27906,58220
2130,Ketchikan Gateway Borough,Alaska,55.58516171,-130.9288093,7060,6744,13804
2150,Kodiak Island Borough,Alaska,57.67704281,-153.7805823,7281,6368,13649
2158,Kusilvak Census Area,Alaska,62.15502018,-163.3826214,4388,3810,8198
2164,Lake and Peninsula Borough,Alaska,58.65291903,-156.1868462,710,665,1375
2170,Matanuska-Susitna Borough,Alaska,62.31621989,-149.571413,53912,49552,103464
2180,Nome Census Area,Alaska,64.91109214,-164.0272117,5240,4685,9925
2185,North Slope Borough,Alaska,69.3121496,-153.4810429,6116,3681,9797
2188,Northwest Arctic Borough,Alaska,67.05300867,-159.7210158,4156,3578,7734
2195,Petersburg Borough,Alaska,57.11951011,-132.9344573,1649,1606,3255
2198,Prince of Wales-Hyder Census Area,Alaska,55.79972761,-133.0191991,3514,2960,6474
2220,Sitka City and Borough,Alaska,57.24007686,-135.3152511,4471,4267,8738
2230,Skagway Municipality,Alaska,59.56296556,-135.3362569,555,506,1061
2240,Southeast Fairbanks Census Area,Alaska,63.87632456,-143.2118133,3779,3097,6876
2261,Valdez-Cordova Census Area,Alaska,61.56195512,-144.468631,4898,4403,9301
2275,Wrangell City and Borough,Alaska,56.33171897,-132.022305,1302,1182,2484
2282,Yakutat City and Borough,Alaska,59.88889523,-140.3576873,369,320,689
2290,Yukon-Koyukuk Census Area,Alaska,65.50864462,-151.389632,2910,2505,5415
4001,Apache ,Arizona,35.39552647,-109.4888223,35240,36282,71522
4003,Cochise ,Arizona,31.87960804,-109.7511677,64135,62144,126279
4005,Coconino ,Arizona,35.83874598,-111.7704914,68918,71299,140217
4007,Gila ,Arizona,33.79975177,-110.8117101,26370,27030,53400
4009,Graham ,Arizona,32.93269987,-109.8873887,20330,17549,37879
4011,Greenlee ,Arizona,33.21523492,-109.2401282,5064,4440,9504
4012,La Paz ,Arizona,33.72924372,-113.9813242,10677,10024,20701
4013,Maricopa ,Arizona,33.34881594,-112.4912914,2104145,2149768,4253913
4015,Mohave ,Arizona,35.70409516,-113.7579527,104047,102017,206064
4017,Navajo ,Arizona,35.39965744,-110.3214014,54533,54172,108705
4019,Pima ,Arizona,32.0974273,-111.7899049,501879,517843,1019722
4021,Pinal ,Arizona,32.90439176,-111.3446708,219048,200673,419721
4023,Santa Cruz ,Arizona,31.52602521,-110.8465877,22285,24299,46584
4025,Yavapai ,Arizona,34.59990366,-112.5539047,109795,114850,224645
4027,Yuma ,Arizona,32.76937662,-113.9055556,106973,100856,207829
5001,Arkansas ,Arkansas,34.29080706,-91.37490973,8733,9391,18124
5003,Ashley ,Arkansas,33.19121135,-91.76845774,10013,10524,20537
5005,Baxter ,Arkansas,36.2872084,-92.33695012,19992,21227,41219
5007,Benton ,Arkansas,36.33872439,-94.25619693,128399,130581,258980
5009,Boone ,Arkansas,36.30859115,-93.09153442,18350,18938,37288
5011,Bradley ,Arkansas,33.46641993,-92.16239824,5214,5734,10948
5013,Calhoun ,Arkansas,33.55803127,-92.50304687,2607,2595,5202
5015,Carroll ,Arkansas,36.34101968,-93.5382382,13897,13990,27887
5017,Chicot ,Arkansas,33.26721483,-91.29398177,5266,5560,10826
5019,Clark ,Arkansas,34.05097067,-93.17636677,10628,11757,22385
5021,Clay ,Arkansas,36.36827123,-90.41755751,7414,7647,15061
5023,Cleburne ,Arkansas,35.53810444,-92.0267275,12472,12758,25230
5025,Cleveland ,Arkansas,33.89837312,-92.18518896,4138,4088,8226
5027,Columbia ,Arkansas,33.21429832,-93.22731371,11444,12448,23892
5029,Conway ,Arkansas,35.26224654,-92.70129383,10182,10724,20906
5031,Craighead ,Arkansas,35.83078059,-90.63283976,51528,54173,105701
5033,Crawford ,Arkansas,35.58908631,-94.24282113,30761,31711,62472
5035,Crittenden ,Arkansas,35.20794386,-90.30883835,23271,25742,49013
5037,Cross ,Arkansas,35.29571522,-90.77121409,8200,8798,16998
5039,Dallas ,Arkansas,33.96980985,-92.65444705,3618,3814,7432
5041,Desha ,Arkansas,33.83328451,-91.25398249,5623,6264,11887
5043,Drew ,Arkansas,33.5894538,-91.72001114,9033,9469,18502
5045,Faulkner ,Arkansas,35.14698117,-92.33204545,59911,62505,122416
5047,Franklin ,Arkansas,35.51232054,-93.89063726,8675,9105,17780
5049,Fulton ,Arkansas,36.3816574,-91.81822519,6048,6091,12139
5051,Garland ,Arkansas,34.57666778,-93.15041074,47182,51114,98296
5053,Grant ,Arkansas,34.29000488,-92.42360629,8870,9216,18086
5055,Greene ,Arkansas,36.11756921,-90.5589636,21912,22711,44623
5057,Hempstead ,Arkansas,33.73532332,-93.66847441,10494,11524,22018
5059,Hot Spring ,Arkansas,34.31762874,-92.94594016,17418,16102,33520
5061,Howard ,Arkansas,34.08890649,-93.99357395,6440,6949,13389
5063,Independence ,Arkansas,35.74157248,-91.56970871,18092,19172,37264
5065,Izard ,Arkansas,36.0948701,-91.91340553,7018,6541,13559
5067,Jackson ,Arkansas,35.59922211,-91.2145661,8512,8713,17225
5069,Jefferson ,Arkansas,34.26878206,-91.93151809,34906,35518,70424
5071,Johnson ,Arkansas,35.5700647,-93.45989301,12976,13315,26291
5073,Lafayette ,Arkansas,33.24094545,-93.60705581,3381,3534,6915
5075,Lawrence ,Arkansas,36.04122682,-91.10709583,8270,8399,16669
5077,Lee ,Arkansas,34.78065179,-90.78212191,5309,4089,9398
5079,Lincoln ,Arkansas,33.95744904,-91.73332986,8590,5105,13695
5081,Little River ,Arkansas,33.70051145,-94.23434658,6090,6327,12417
5083,Logan ,Arkansas,35.21527068,-93.71634187,10643,11114,21757
5085,Lonoke ,Arkansas,34.75425622,-91.8886733,35667,36539,72206
5087,Madison ,Arkansas,36.01095244,-93.72455118,8038,8038,16076
5089,Marion ,Arkansas,36.26838614,-92.68422483,7990,8448,16438
5091,Miller ,Arkansas,33.31209067,-93.89155271,21476,22283,43759
5093,Mississippi ,Arkansas,35.7638336,-90.05420095,20876,21955,42831
5095,Monroe ,Arkansas,34.67784528,-91.20390435,3316,3933,7249
5097,Montgomery ,Arkansas,34.53881077,-93.65952878,4440,4553,8993
5099,Nevada ,Arkansas,33.66396327,-93.30719906,4425,4015,8440
5101,Newton ,Arkansas,35.91997206,-93.21786865,3932,3916,7848
5103,Ouachita ,Arkansas,33.59335287,-92.88194023,11327,12779,24106
5105,Perry ,Arkansas,34.94736989,-92.93144274,5184,5138,10322
5107,Phillips ,Arkansas,34.42823806,-90.84806629,9006,10028,19034
5109,Pike ,Arkansas,34.16352177,-93.65632702,5346,5462,10808
5111,Poinsett ,Arkansas,35.57401479,-90.66297675,11734,12320,24054
5113,Polk ,Arkansas,34.4859135,-94.228094,9828,10335,20163
5115,Pope ,Arkansas,35.44762758,-93.03415222,31317,32327,63644
5117,Prairie ,Arkansas,34.82979854,-91.55279743,4120,4124,8244
5119,Pulaski ,Arkansas,34.76994017,-92.31178372,188496,204967,393463
5121,Randolph ,Arkansas,36.34145903,-91.02770853,8784,8819,17603
5123,St. Francis ,Arkansas,35.02200956,-90.74776577,14441,11853,26294
5125,Saline ,Arkansas,34.64659516,-92.67652323,58030,59979,118009
5127,Scott ,Arkansas,34.86077478,-94.06323826,5332,5110,10442
5129,Searcy ,Arkansas,35.91089957,-92.69950814,3981,3942,7923
5131,Sebastian ,Arkansas,35.19966033,-94.27417847,62274,65187,127461
5133,Sevier ,Arkansas,33.99717541,-94.2411776,8607,8586,17193
5135,Sharp ,Arkansas,36.16114163,-91.47985752,8335,8708,17043
5137,Stone ,Arkansas,35.85988028,-92.15670323,6209,6237,12446
5139,Union ,Arkansas,33.17130192,-92.59726944,19332,20400,39732
5141,Van Buren ,Arkansas,35.5806447,-92.5156838,8284,8400,16684
5143,Washington ,Arkansas,35.97906307,-94.21557553,114181,114348,228529
5145,White ,Arkansas,35.25627781,-91.7455496,38751,40053,78804
5147,Woodruff ,Arkansas,35.18630641,-91.24305628,3051,3609,6660
5149,Yell ,Arkansas,35.00261093,-93.41123285,10782,10791,21573
6001,Alameda ,California,37.64689323,-121.8888675,807171,836529,1643700
6003,Alpine ,California,38.59719677,-119.8206697,612,534,1146
6005,Amador ,California,38.44639149,-120.6510933,20302,17527,37829
6007,Butte ,California,39.66693534,-121.6006808,112513,114562,227075
6009,Calaveras ,California,38.20459548,-120.554128,22434,22801,45235
6011,Colusa ,California,39.17748403,-122.2369591,11124,10340,21464
6013,Contra Costa ,California,37.91912234,-121.9277882,553701,579546,1133247
6015,Del Norte ,California,41.7431349,-123.89724,14575,12849,27424
6017,El Dorado ,California,38.7787355,-120.5246574,93040,93621,186661
6019,Fresno ,California,36.75819764,-119.6493072,487936,490194,978130
6021,Glenn ,California,39.59820149,-122.391999,14171,13726,27897
6023,Humboldt ,California,40.69929754,-123.8756289,67666,68102,135768
6025,Imperial ,California,33.03951207,-115.3653512,92250,87966,180216
6027,Inyo ,California,36.51111376,-117.410748,9084,9001,18085
6029,Kern ,California,35.34286436,-118.7299164,452646,430407,883053
6031,Kings ,California,36.07534371,-119.8155507,82674,67401,150075
6033,Lake ,California,39.09961721,-122.7531899,31879,32269,64148
6035,Lassen ,California,40.6735891,-120.5943154,20671,10514,31185
6037,Los Angeles ,California,34.32074296,-118.22481,4976788,5121264,10098052
6039,Madera ,California,37.2179921,-119.7626704,74683,80330,155013
6041,Marin ,California,38.07338556,-122.7234156,127113,133182,260295
6043,Mariposa ,California,37.5815082,-119.9054261,8920,8620,17540
6045,Mendocino ,California,39.4402241,-123.3914726,43439,43983,87422
6047,Merced ,California,37.19188986,-120.7176523,135816,133259,269075
6049,Modoc ,California,41.58981656,-120.7250156,4613,4325,8938
6051,Mono ,California,37.93908943,-118.8868431,7341,6833,14174
6053,Monterey ,California,36.21715891,-121.2392006,220967,212245,433212
6055,Napa ,California,38.50648545,-122.3305181,70082,70448,140530
6057,Nevada ,California,39.30136306,-120.7684511,48889,50203,99092
6059,Orange ,California,33.70297218,-117.76107,1562429,1601753,3164182
6061,Placer ,California,39.06345957,-120.7175588,185511,194566,380077
6063,Plumas ,California,40.00463843,-120.8385457,9423,9276,18699
6065,Riverside ,California,33.74366319,-115.9938065,1186188,1197098,2383286
6067,Sacramento ,California,38.44931685,-121.3442534,737742,772281,1510023
6069,San Benito ,California,36.60569063,-121.0749693,29626,29790,59416
6071,San Bernardino ,California,34.84139921,-116.17841,1062472,1072941,2135413
6073,San Diego ,California,33.03413671,-116.7352929,1661931,1640902,3302833
6075,San Francisco ,California,37.75616437,-122.4430417,443970,426074,870044
6077,San Joaquin ,California,37.93475479,-121.2713924,364612,367600,732212
6079,San Luis Obispo ,California,35.38708294,-120.404516,142769,138686,281455
6081,San Mateo ,California,37.42289743,-122.3290165,377851,388084,765935
6083,Santa Barbara ,California,34.67287989,-120.0164734,222208,221530,443738
6085,Santa Clara ,California,37.23178503,-121.6951263,970469,951731,1922200
6087,Santa Cruz ,California,37.05618849,-122.0018496,135727,138038,273765
6089,Shasta ,California,40.76371327,-122.040499,87859,91226,179085
6091,Sierra ,California,39.5803262,-120.5159952,1542,1388,2930
6093,Siskiyou ,California,41.5926754,-122.5403513,21706,21834,43540
6095,Solano ,California,38.26997291,-121.9328519,217931,220599,438530
6097,Sonoma ,California,38.52828659,-122.8874079,245196,256121,501317
6099,Stanislaus ,California,37.55913408,-120.9976881,266844,272457,539301
6101,Sutter ,California,39.03457773,-121.6948438,47789,48083,95872
6103,Tehama ,California,40.12562627,-122.2340586,31504,31869,63373
6105,Trinity ,California,40.65069929,-123.1126397,6582,6280,12862
6107,Tulare ,California,36.22016552,-118.8004876,230255,230222,460477
6109,Tuolumne ,California,38.02758891,-119.954755,28102,25830,53932
6111,Ventura ,California,34.45650806,-119.0836332,419588,428524,848112
6113,Yolo ,California,38.68661923,-121.9015698,104375,110602,214977
6115,Yuba ,California,39.26900718,-121.3512643,38468,37025,75493
8001,Adams ,Colorado,39.87363084,-104.3377687,250704,246411,497115
8003,Alamosa ,Colorado,37.57293535,-105.7883668,8242,8202,16444
8005,Arapahoe ,Colorado,39.64975685,-104.3392298,314672,321999,636671
8007,Archuleta ,Colorado,37.19353673,-107.0482875,6546,6362,12908
8009,Baca ,Colorado,37.31919023,-102.5603746,1755,1808,3563
8011,Bent ,Colorado,37.95507595,-103.0717097,3790,2019,5809
8013,Boulder ,Colorado,40.09248855,-105.3577296,161355,159675,321030
8014,Broomfield ,Colorado,39.95410592,-105.0527106,32789,33331,66120
8015,Chaffee ,Colorado,38.74701251,-106.1941266,10268,8896,19164
8017,Cheyenne ,Colorado,38.82795187,-102.603508,964,1075,2039
8019,Clear Creek ,Colorado,39.68917973,-105.6444023,4816,4563,9379
8021,Conejos ,Colorado,37.20071264,-106.1916103,4082,4060,8142
8023,Costilla ,Colorado,37.27812432,-105.4282354,1941,1746,3687
8025,Crowley ,Colorado,38.32658633,-103.7844708,3526,2104,5630
8027,Custer ,Colorado,38.10869123,-105.3675281,2265,2375,4640
8029,Delta ,Colorado,38.86135915,-107.8628892,15235,15111,30346
8031,Denver ,Colorado,39.76213212,-104.8758698,347188,346229,693417
8033,Dolores ,Colorado,37.75171176,-108.5174003,989,852,1841
8035,Douglas ,Colorado,39.3297082,-104.9295593,163766,164848,328614
8037,Eagle ,Colorado,39.62784556,-106.6953664,28804,25553,54357
8039,Elbert ,Colorado,39.2865834,-104.135943,12721,12441,25162
8041,El Paso ,Colorado,38.83210344,-104.5254603,347478,340675,688153
8043,Fremont ,Colorado,38.47295815,-105.4396582,27324,19678,47002
8045,Garfield ,Colorado,39.59931537,-107.9040312,29779,28759,58538
8047,Gilpin ,Colorado,39.8575621,-105.5225161,3169,2755,5924
8049,Grand ,Colorado,40.10263077,-106.1183305,8129,6937,15066
8051,Gunnison ,Colorado,38.66676545,-107.0316224,8983,7554,16537
8053,Hinsdale ,Colorado,37.8212848,-107.3003019,406,472,878
8055,Huerfano ,Colorado,37.68467851,-104.9606113,3305,3278,6583
8057,Jackson ,Colorado,40.66644568,-106.34279,631,665,1296
8059,Jefferson ,Colorado,39.58643529,-105.250469,283919,286508,570427
8061,Kiowa ,Colorado,38.43266867,-102.7402903,750,699,1449
8063,Kit Carson ,Colorado,39.30549435,-102.6029457,4158,3477,7635
8065,Lake ,Colorado,39.20248013,-106.3447801,4176,3409,7585
8067,La Plata ,Colorado,37.28655414,-107.8433296,27790,27311,55101
8069,Larimer ,Colorado,40.66638617,-105.4611455,168615,169546,338161
8071,Las Animas ,Colorado,37.31578856,-104.0386423,7452,6727,14179
8073,Lincoln ,Colorado,38.98808785,-103.5139431,3471,2077,5548
8075,Logan ,Colorado,40.72467278,-103.1101244,11708,9981,21689
8077,Mesa ,Colorado,39.01830152,-108.4664424,74027,75971,149998
8079,Mineral ,Colorado,37.66894229,-106.9241219,402,421,823
8081,Moffat ,Colorado,40.61839473,-108.2074434,6698,6362,13060
8083,Montezuma ,Colorado,37.33856249,-108.5965771,12760,13149,25909
8085,Montrose ,Colorado,38.402183,-108.269338,20374,20894,41268
8087,Morgan ,Colorado,40.26264077,-103.8097165,14112,14145,28257
8089,Otero ,Colorado,37.90256806,-103.7165119,8872,9453,18325
8091,Ouray ,Colorado,38.15546514,-107.7692713,2312,2410,4722
8093,Park ,Colorado,39.11931309,-105.7171098,9172,8220,17392
8095,Phillips ,Colorado,40.59397332,-102.3576012,2295,2023,4318
8097,Pitkin ,Colorado,39.21708542,-106.9165986,9408,8501,17909
8099,Prowers ,Colorado,37.95519537,-102.3933597,6035,6017,12052
8101,Pueblo ,Colorado,38.17352289,-104.5127322,80962,83723,164685
8103,Rio Blanco ,Colorado,39.97985128,-108.2170523,3291,3174,6465
8105,Rio Grande ,Colorado,37.58251943,-106.3832299,5696,5655,11351
8107,Routt ,Colorado,40.48514361,-106.9912534,12915,11959,24874
8109,Saguache ,Colorado,38.08052661,-106.2815064,3182,3286,6468
8111,San Juan ,Colorado,37.7640285,-107.6761566,283,261,544
8113,San Miguel ,Colorado,38.00376523,-108.4057279,4215,3753,7968
8115,Sedgwick ,Colorado,40.87591672,-102.3518248,1162,1188,2350
8117,Summit ,Colorado,39.6341803,-106.116368,16684,13745,30429
8119,Teller ,Colorado,38.88215683,-105.1617789,12157,11956,24113
8121,Washington ,Colorado,39.97101752,-103.2012456,2510,2330,4840
8123,Weld ,Colorado,40.55483429,-104.3924615,148627,146496,295123
8125,Yuma ,Colorado,40.00293655,-102.4242485,5019,5050,10069
9001,Fairfield ,Connecticut,41.27079518,-73.38938077,459963,484385,944348
9003,Hartford ,Connecticut,41.80640592,-72.73287269,434650,460080,894730
9005,Litchfield ,Connecticut,41.79248073,-73.24533246,90447,92584,183031
9007,Middlesex ,Connecticut,41.46318767,-72.53514428,79676,83692,163368
9009,New Haven ,Connecticut,41.41047805,-72.93207762,414311,445028,859339
9011,New London ,Connecticut,41.48661392,-72.10147371,134703,134178,268881
9013,Tolland ,Connecticut,41.8550418,-72.33647702,75821,75448,151269
9015,Windham ,Connecticut,41.8300196,-71.98743898,57560,58978,116538
10001,Kent ,Delaware,39.08616893,-75.56842232,84271,90551,174822
10003,New Castle ,Delaware,39.57683344,-75.65269159,268870,286263,555133
10005,Sussex ,Delaware,38.66055293,-75.39003806,106429,113111,219540
11001,District of Columbia,District of Columbia,38.90473394,-77.01629384,324881,359617,684498
12001,Alachua ,Florida,29.67474972,-82.35771368,127298,135850,263148
12003,Baker ,Florida,30.33109792,-82.28462852,14753,13032,27785
12005,Bay ,Florida,30.26521549,-85.62024282,90768,91714,182482
12007,Bradford ,Florida,29.94994876,-82.16876767,14841,12138,26979
12009,Brevard ,Florida,28.29372186,-80.7322705,282023,294785,576808
12011,Broward ,Florida,26.15232238,-80.48712563,929712,979439,1909151
12013,Calhoun ,Florida,30.40602254,-85.19719429,8048,6396,14444
12015,Charlotte ,Florida,26.90548522,-81.91226117,86278,90676,176954
12017,Citrus ,Florida,28.84891085,-82.47939452,69376,73711,143087
12019,Clay ,Florida,29.98306336,-81.8578775,102225,105066,207291
12021,Collier ,Florida,26.11071565,-81.34757344,179336,184586,363922
12023,Columbia ,Florida,30.22424805,-82.62153929,35683,33422,69105
12027,DeSoto ,Florida,27.18636318,-81.80950448,20657,15742,36399
12029,Dixie ,Florida,29.6081916,-83.15880037,9218,7219,16437
12031,Duval ,Florida,30.33157316,-81.67084283,448163,476066,924229
12033,Escambia ,Florida,30.66892673,-87.362783,154520,157002,311522
12035,Flagler ,Florida,29.46142485,-81.31356839,51187,55952,107139
12037,Franklin ,Florida,29.87646472,-84.81402385,6714,5022,11736
12039,Gadsden ,Florida,30.57947808,-84.61362454,21785,24232,46017
12041,Gilchrist ,Florida,29.72583212,-82.80037638,9249,8366,17615
12043,Glades ,Florida,26.95643071,-81.18907378,7303,6060,13363
12045,Gulf ,Florida,29.95553379,-85.22659118,9586,6469,16055
12047,Hamilton ,Florida,30.49638882,-82.9479328,8281,5988,14269
12049,Hardee ,Florida,27.49270249,-81.80998298,14705,12523,27228
12051,Hendry ,Florida,26.55348333,-81.16585111,21437,18690,40127
12053,Hernando ,Florida,28.55363187,-82.42503829,87747,94949,182696
12055,Highlands ,Florida,27.34329434,-81.3410383,49727,52374,102101
12057,Hillsborough ,Florida,27.92907665,-82.30919543,673286,705597,1378883
12059,Holmes ,Florida,30.86792107,-85.81401731,10484,8946,19430
12061,Indian River ,Florida,27.69431171,-80.60624481,72290,78694,150984
12063,Jackson ,Florida,30.79542473,-85.21549244,26784,21688,48472
12065,Jefferson ,Florida,30.43748929,-83.89529238,7507,6598,14105
12067,Lafayette ,Florida,29.98550163,-83.18109169,5066,3678,8744
12069,Lake ,Florida,28.7615363,-81.71126372,162402,172960,335362
12071,Lee ,Florida,26.57778609,-81.83374252,351918,366761,718679
12073,Leon ,Florida,30.45804082,-84.27789669,136894,151208,288102
12075,Levy ,Florida,29.31842893,-82.74355312,19364,20597,39961
12077,Liberty ,Florida,30.24137449,-84.88289858,5110,3255,8365
12079,Madison ,Florida,30.4441189,-83.47012097,9829,8645,18474
12081,Manatee ,Florida,27.47190568,-82.31531846,180595,193258,373853
12083,Marion ,Florida,29.21020748,-82.05665151,167211,181160,348371
12085,Martin ,Florida,27.07752204,-80.43147132,78002,79579,157581
12086,Miami-Dade ,Florida,25.61495929,-80.56228896,1318627,1396889,2715516
12087,Monroe ,Florida,25.3156183,-81.1106363,39822,36503,76325
12089,Nassau ,Florida,30.61059899,-81.80161576,39956,40622,80578
12091,Okaloosa ,Florida,30.69128366,-86.59172167,101745,98992,200737
12093,Okeechobee ,Florida,27.38644235,-80.88863139,21866,18706,40572
12095,Orange ,Florida,28.51442465,-81.32351241,648446,672748,1321194
12097,Osceola ,Florida,28.06268562,-81.14947488,166820,171799,338619
12099,Palm Beach ,Florida,26.64759584,-80.46551002,701207,745070,1446277
12101,Pasco ,Florida,28.30909548,-82.39319538,248572,262021,510593
12103,Pinellas ,Florida,27.91960154,-82.72559904,459766,498109,957875
12105,Polk ,Florida,27.9488798,-81.69757667,327706,340965,668671
12107,Putnam ,Florida,29.60865249,-81.74430345,35841,36925,72766
12109,St. Johns ,Florida,29.90164112,-81.44066458,114660,120843,235503
12111,St. Lucie ,Florida,27.37725646,-80.47202647,149385,156206,305591
12113,Santa Rosa ,Florida,30.70044159,-87.02197834,87175,83267,170442
12115,Sarasota ,Florida,27.18446789,-82.33150444,196433,215711,412144
12117,Seminole ,Florida,28.71697276,-81.2363175,219935,235151,455086
12119,Sumter ,Florida,28.704756,-82.08097332,60725,60274,120999
12121,Suwannee ,Florida,30.19560506,-82.99149468,22230,21694,43924
12123,Taylor ,Florida,30.04701274,-83.60352701,12414,9684,22098
12125,Union ,Florida,30.04385497,-82.37143421,9919,5320,15239
12127,Volusia ,Florida,29.05842069,-81.18192065,257275,270359,527634
12129,Wakulla ,Florida,30.16731986,-84.40067671,17490,14387,31877
12131,Walton ,Florida,30.64358166,-86.16965568,33317,32541,65858
12133,Washington ,Florida,30.61060117,-85.66533264,13231,11335,24566
13001,Appling ,Georgia,31.74922311,-82.28889645,9353,9101,18454
13003,Atkinson ,Georgia,31.29713318,-82.88007087,4208,4057,8265
13005,Bacon ,Georgia,31.55368009,-82.45269851,5564,5664,11228
13007,Baker ,Georgia,31.32614478,-84.44471523,1521,1668,3189
13009,Baldwin ,Georgia,33.06926621,-83.2495557,22759,22527,45286
13011,Banks ,Georgia,34.35415051,-83.4973769,9281,9229,18510
13013,Barrow ,Georgia,33.99318851,-83.71273177,37771,39116,76887
13015,Bartow ,Georgia,34.23786493,-84.84049136,51332,52288,103620
13017,Ben Hill ,Georgia,31.75979097,-83.22050663,8047,9107,17154
13019,Berrien ,Georgia,31.27595307,-83.22963868,9299,9726,19025
13021,Bibb ,Georgia,32.80649504,-83.69740491,72065,81425,153490
13023,Bleckley ,Georgia,32.43444534,-83.32781353,5937,6838,12775
13025,Brantley ,Georgia,31.19687588,-81.98190369,9103,9458,18561
13027,Brooks ,Georgia,30.84198089,-83.58020128,7608,8014,15622
13029,Bryan ,Georgia,32.01447125,-81.44363801,17786,18099,35885
13031,Bulloch ,Georgia,32.3968077,-81.7431811,36777,38005,74782
13033,Burke ,Georgia,33.0610815,-82.00090103,10697,11853,22550
13035,Butts ,Georgia,33.28788112,-83.95718513,12661,11089,23750
13037,Calhoun ,Georgia,31.52922229,-84.62453275,3875,2553,6428
13039,Camden ,Georgia,30.93056291,-81.66997639,27019,25695,52714
13043,Candler ,Georgia,32.40344187,-82.07366027,5363,5464,10827
13045,Carroll ,Georgia,33.58278636,-85.07976835,56448,59574,116022
13047,Catoosa ,Georgia,34.9036289,-85.13824955,31991,34308,66299
13049,Charlton ,Georgia,30.78172967,-82.13793184,7522,5461,12983
13051,Chatham ,Georgia,32.00421553,-81.13283525,138403,148646,287049
13053,Chattahoochee ,Georgia,32.34698433,-84.7870209,7172,3595,10767
13055,Chattooga ,Georgia,34.47500026,-85.34534078,12865,11952,24817
13057,Cherokee ,Georgia,34.2439499,-84.47619175,119270,122640,241910
13059,Clarke ,Georgia,33.95117829,-83.36733045,59248,65354,124602
13061,Clay ,Georgia,31.62623788,-84.98008739,1473,1528,3001
13063,Clayton ,Georgia,33.54190471,-84.35764423,130748,147918,278666
13065,Clinch ,Georgia,30.9149953,-82.70625716,3427,3316,6743
13067,Cobb ,Georgia,33.9414814,-84.57669232,360270,384787,745057
13069,Coffee ,Georgia,31.54928577,-82.84917705,22088,20873,42961
13071,Colquitt ,Georgia,31.18837686,-83.76879849,22554,23052,45606
13073,Columbia ,Georgia,33.54411701,-82.26403887,71970,75325,147295
13075,Cook ,Georgia,31.15399291,-83.43046305,8348,8836,17184
13077,Coweta ,Georgia,33.35346426,-84.76335813,68430,72086,140516
13079,Crawford ,Georgia,32.71451075,-83.9863297,6299,6045,12344
13081,Crisp ,Georgia,31.92291153,-83.76805458,10849,11997,22846
13083,Dade ,Georgia,34.85455198,-85.50451949,7932,8295,16227
13085,Dawson ,Georgia,34.44429665,-84.17062681,11774,12087,23861
13087,Decatur ,Georgia,30.87834851,-84.57904679,12907,13926,26833
13089,DeKalb ,Georgia,33.77153603,-84.22642599,351871,391316,743187
13091,Dodge ,Georgia,32.17220686,-83.16840542,10972,9947,20919
13093,Dooly ,Georgia,32.15718704,-83.79879578,7529,6376,13905
13095,Dougherty ,Georgia,31.53346418,-84.21638639,42144,48905,91049
13097,Douglas ,Georgia,33.70184254,-84.76795535,67726,74114,141840
13099,Early ,Georgia,31.32282807,-84.90365602,4791,5557,10348
13101,Echols ,Georgia,30.7100504,-82.89396144,1973,2021,3994
13103,Effingham ,Georgia,32.36728627,-81.34135178,29215,29474,58689
13105,Elbert ,Georgia,34.11679504,-82.84014598,9188,10024,19212
13107,Emanuel ,Georgia,32.58973973,-82.30171317,11105,11394,22499
13109,Evans ,Georgia,32.15676456,-81.88688163,5303,5424,10727
13111,Fannin ,Georgia,34.86408399,-84.31983387,12086,12839,24925
13113,Fayette ,Georgia,33.41395332,-84.49418416,54055,57314,111369
13115,Floyd ,Georgia,34.26318326,-85.21425983,46810,50014,96824
13117,Forsyth ,Georgia,34.22554325,-84.12502041,109258,110622,219880
13119,Franklin ,Georgia,34.37544017,-83.22915634,10853,11661,22514
13121,Fulton ,Georgia,33.79028194,-84.46699086,495087,526815,1021902
13123,Gilmer ,Georgia,34.69116301,-84.45562504,15079,14843,29922
13125,Glascock ,Georgia,33.22928289,-82.61070062,1438,1571,3009
13127,Glynn ,Georgia,31.23089649,-81.54071677,39419,44555,83974
13129,Gordon ,Georgia,34.50336057,-84.87570724,28001,28789,56790
13131,Grady ,Georgia,30.87466591,-84.23444072,12176,12750,24926
13133,Greene ,Georgia,33.57883025,-83.1666706,8299,8677,16976
13135,Gwinnett ,Georgia,33.96172854,-84.0235947,441051,461247,902298
13137,Habersham ,Georgia,34.63102797,-83.53112369,20962,23327,44289
13139,Hall ,Georgia,34.31690076,-83.81966681,97518,98443,195961
13141,Hancock ,Georgia,33.27045137,-83.00067259,5193,3342,8535
13143,Haralson ,Georgia,33.79421744,-85.21101885,14041,14915,28956
13145,Harris ,Georgia,32.7360391,-84.90889194,16832,16758,33590
13147,Hart ,Georgia,34.35083482,-82.96422076,12558,13073,25631
13149,Heard ,Georgia,33.29703942,-85.12833608,5747,5930,11677
13151,Henry ,Georgia,33.45300248,-84.15420612,105759,115548,221307
13153,Houston ,Georgia,32.45900725,-83.66622618,73756,77926,151682
13155,Irwin ,Georgia,31.60221364,-83.27635387,4758,4510,9268
13157,Jackson ,Georgia,34.13388571,-83.56636587,32445,33310,65755
13159,Jasper ,Georgia,33.31639587,-83.68805768,6682,7102,13784
13161,Jeff Davis ,Georgia,31.80559289,-82.63683939,7408,7583,14991
13163,Jefferson ,Georgia,33.05486535,-82.41817747,7605,8167,15772
13165,Jenkins ,Georgia,32.79244727,-81.96354954,4055,4772,8827
13167,Johnson ,Georgia,32.70146072,-82.66007951,5318,4412,9730
13169,Jones ,Georgia,33.02512491,-83.5604948,13874,14674,28548
13171,Lamar ,Georgia,33.07653569,-84.13947124,8959,9554,18513
13173,Lanier ,Georgia,31.03787301,-83.06275656,5183,5183,10366
13175,Laurens ,Georgia,32.46365199,-82.92223334,22497,24921,47418
13177,Lee ,Georgia,31.77955418,-84.1411601,14674,14674,29348
13179,Liberty ,Georgia,31.82809043,-81.49472957,31550,30558,62108
13181,Lincoln ,Georgia,33.79363681,-82.45114028,3683,4116,7799
13183,Long ,Georgia,31.7525552,-81.74569517,8872,9284,18156
13185,Lowndes ,Georgia,30.83381348,-83.26772968,55959,58623,114582
13187,Lumpkin ,Georgia,34.57218744,-84.00267573,15551,16400,31951
13189,McDuffie ,Georgia,33.48286164,-82.48136662,9999,11499,21498
13191,McIntosh ,Georgia,31.49665949,-81.40846876,7036,7084,14120
13193,Macon ,Georgia,32.35838315,-84.04249465,7342,6138,13480
13195,Madison ,Georgia,34.12778417,-83.20903989,14508,14392,28900
13197,Marion ,Georgia,32.35339325,-84.52466883,4203,4281,8484
13199,Meriwether ,Georgia,33.04066422,-84.68831071,10221,10892,21113
13201,Miller ,Georgia,31.16400523,-84.73078383,2832,3004,5836
13205,Mitchell ,Georgia,31.22532031,-84.19427547,11683,10749,22432
13207,Monroe ,Georgia,33.01392415,-83.91865755,13600,13410,27010
13209,Montgomery ,Georgia,32.17339368,-82.53477358,4633,4403,9036
13211,Morgan ,Georgia,33.5908033,-83.49237353,8783,9452,18235
13213,Murray ,Georgia,34.78842922,-84.74806874,19522,20035,39557
13215,Muscogee ,Georgia,32.51002371,-84.87706039,96279,100391,196670
13217,Newton ,Georgia,33.55503916,-83.85019177,50598,55899,106497
13219,Oconee ,Georgia,33.8349652,-83.43710308,18164,18853,37017
13221,Oglethorpe ,Georgia,33.88066819,-83.08070772,7396,7388,14784
13223,Paulding ,Georgia,33.9205335,-84.86729516,76195,79645,155840
13225,Peach ,Georgia,32.5687555,-83.82689023,12952,14014,26966
13227,Pickens ,Georgia,34.46432656,-84.46555469,15233,15599,30832
13229,Pierce ,Georgia,31.35876961,-82.21276281,9639,9525,19164
13231,Pike ,Georgia,33.09228331,-84.38925957,8876,9206,18082
13233,Polk ,Georgia,34.00179086,-85.18814291,20415,21206,41621
13235,Pulaski ,Georgia,32.23229646,-83.47596447,5075,6220,11295
13237,Putnam ,Georgia,33.32176673,-83.37279374,10402,11101,21503
13239,Quitman ,Georgia,31.86734739,-85.01877003,1081,1195,2276
13241,Rabun ,Georgia,34.88173556,-83.40208022,8107,8350,16457
13243,Randolph ,Georgia,31.76265515,-84.75418864,3493,3594,7087
13245,Richmond ,Georgia,33.35959195,-82.0735036,97272,104191,201463
13247,Rockdale ,Georgia,33.6542507,-84.02659007,41944,47067,89011
13249,Schley ,Georgia,32.26166256,-84.31475698,2546,2665,5211
13251,Screven ,Georgia,32.75060543,-81.61194171,6804,7186,13990
13253,Seminole ,Georgia,30.93878566,-84.86883881,4027,4410,8437
13255,Spalding ,Georgia,33.26088685,-84.28409469,31395,33324,64719
13257,Stephens ,Georgia,34.553942,-83.29347238,11765,13911,25676
13259,Stewart ,Georgia,32.07848971,-84.83521705,3894,2148,6042
13261,Sumter ,Georgia,32.03994282,-84.19699392,14359,15993,30352
13263,Talbot ,Georgia,32.69949851,-84.53300952,3032,3346,6378
13265,Taliaferro ,Georgia,33.56613476,-82.87877142,847,818,1665
13267,Tattnall ,Georgia,32.04579765,-82.05812943,14888,10465,25353
13269,Taylor ,Georgia,32.5554764,-84.25047428,3946,4247,8193
13271,Telfair ,Georgia,31.92980587,-82.93901137,9346,6769,16115
13273,Terrell ,Georgia,31.77699791,-84.43696998,4228,4631,8859
13275,Thomas ,Georgia,30.86376393,-83.91932776,21219,23511,44730
13277,Tift ,Georgia,31.45742933,-83.52660088,19509,21001,40510
13279,Toombs ,Georgia,32.12161158,-82.33121596,12491,14557,27048
13281,Towns ,Georgia,34.91671068,-83.73730603,5334,6083,11417
13283,Treutlen ,Georgia,32.4038748,-82.5672882,3573,3204,6777
13285,Troup ,Georgia,33.03353963,-85.02836515,33387,36387,69774
13287,Turner ,Georgia,31.71638192,-83.62409158,3843,4119,7962
13289,Twiggs ,Georgia,32.66720049,-83.42707722,4068,4216,8284
13291,Union ,Georgia,34.83408735,-83.99071663,11048,11727,22775
13293,Upson ,Georgia,32.8812748,-84.29934918,12503,13713,26216
13295,Walker ,Georgia,34.73564649,-85.30099086,34082,34742,68824
13297,Walton ,Georgia,33.78155675,-83.73386981,43775,46357,90132
13299,Ware ,Georgia,31.05378855,-82.42371808,17753,17846,35599
13301,Warren ,Georgia,33.40894817,-82.67675069,2475,2871,5346
13303,Washington ,Georgia,32.96953472,-82.79593023,10361,10100,20461
13305,Wayne ,Georgia,31.55144752,-81.91672491,15051,14716,29767
13307,Webster ,Georgia,32.04664019,-84.55104518,1254,1359,2613
13309,Wheeler ,Georgia,32.11705424,-82.72458014,5007,2932,7939
13311,White ,Georgia,34.64641039,-83.74710566,14128,14800,28928
13313,Whitfield ,Georgia,34.80561127,-84.96720773,51525,52324,103849
13315,Wilcox ,Georgia,31.97289724,-83.43234538,5242,3604,8846
13317,Wilkes ,Georgia,33.78194965,-82.74319598,4770,5114,9884
13319,Wilkinson ,Georgia,32.80238192,-83.17123808,4349,4729,9078
13321,Worth ,Georgia,31.55149984,-83.85089246,10040,10616,20656
15001,Hawaii ,Hawaii,19.59872083,-155.5184935,98276,99382,197658
15003,Honolulu ,Hawaii,21.50078536,-158.1053342,497646,489992,987638
15005,Kalawao ,Hawaii,21.17088724,-156.9475293,38,37,75
15007,Kauai ,Hawaii,22.03962537,-159.5963488,35375,36002,71377
15009,Maui ,Hawaii,20.85964011,-156.5648463,82437,82844,165281
16001,Ada ,Idaho,43.45109241,-116.2411609,223367,222685,446052
16003,Adams ,Idaho,44.88959322,-116.4538254,2093,1926,4019
16005,Bannock ,Idaho,42.66848737,-112.2246106,42300,42765,85065
16007,Bear Lake ,Idaho,42.28478415,-111.329687,2898,3064,5962
16009,Benewah ,Idaho,47.21755258,-116.6587089,4607,4479,9086
16011,Bingham ,Idaho,43.21655175,-112.3980933,22746,22805,45551
16013,Blaine ,Idaho,43.41194442,-113.9801748,11251,10743,21994
16015,Boise ,Idaho,43.98913017,-115.7303632,3780,3383,7163
16017,Bonner ,Idaho,48.3000432,-116.6010756,21366,21345,42711
16019,Bonneville ,Idaho,43.38773727,-111.6147913,56237,56160,112397
16021,Boundary ,Idaho,48.76686857,-116.4628743,5735,5814,11549
16023,Butte ,Idaho,43.72291219,-113.1720674,1342,1260,2602
16025,Camas ,Idaho,43.46332937,-114.8057674,433,453,886
16027,Canyon ,Idaho,43.62513687,-116.7093126,104902,107328,212230
16029,Caribou ,Idaho,42.77049662,-111.5622598,3543,3375,6918
16031,Cassia ,Idaho,42.28388223,-113.6001008,12039,11576,23615
16033,Clark ,Idaho,44.2839185,-112.3512464,570,507,1077
16035,Clearwater ,Idaho,46.67364382,-115.6566841,4790,3850,8640
16037,Custer ,Idaho,44.24112591,-114.2817281,2165,1976,4141
16039,Elmore ,Idaho,43.35395514,-115.4692972,13858,12575,26433
16041,Franklin ,Idaho,42.18109938,-111.8131968,6787,6492,13279
16043,Fremont ,Idaho,44.22879173,-111.4819403,6766,6199,12965
16045,Gem ,Idaho,44.06154619,-116.3975166,8354,8698,17052
16047,Gooding ,Idaho,42.97102592,-114.8115383,7911,7258,15169
16049,Idaho ,Idaho,45.84406963,-115.4675088,8537,7800,16337
16051,Jefferson ,Idaho,43.82015472,-112.3113082,14295,13674,27969
16053,Jerome ,Idaho,42.68987596,-114.2639256,11801,11630,23431
16055,Kootenai ,Idaho,47.67437463,-116.7018262,75890,77715,153605
16057,Latah ,Idaho,46.81617004,-116.7116819,19894,19345,39239
16059,Lemhi ,Idaho,44.94325575,-113.933252,3948,3850,7798
16061,Lewis ,Idaho,46.23700097,-116.4263151,1911,1934,3845
16063,Lincoln ,Idaho,43.0023727,-114.1382739,2766,2555,5321
16065,Madison ,Idaho,43.78414736,-111.6592342,19529,19176,38705
16067,Minidoka ,Idaho,42.85429247,-113.6374701,10377,10238,20615
16069,Nez Perce ,Idaho,46.32681553,-116.7502431,19758,20397,40155
16071,Oneida ,Idaho,42.19497441,-112.5393663,2083,2243,4326
16073,Owyhee ,Idaho,42.58149964,-116.1699154,5874,5581,11455
16075,Payette ,Idaho,44.006757,-116.7608211,11470,11571,23041
16077,Power ,Idaho,42.69364441,-112.8406693,3781,3932,7713
16079,Shoshone ,Idaho,47.35294081,-115.8923629,6267,6259,12526
16081,Teton ,Idaho,43.7594455,-111.2076218,5887,5193,11080
16083,Twin Falls ,Idaho,42.35596962,-114.6671507,41204,42462,83666
16085,Valley ,Idaho,44.76660706,-115.5663374,5486,4915,10401
16087,Washington ,Idaho,44.45242382,-116.7847363,4966,5059,10025
17001,Adams ,Illinois,39.98787833,-91.18855699,32481,33946,66427
17003,Alexander ,Illinois,37.19151912,-89.33756197,3104,3428,6532
17005,Bond ,Illinois,38.88683305,-89.43554637,8587,8125,16712
17007,Boone ,Illinois,42.32307877,-88.82338303,26830,26776,53606
17009,Brown ,Illinois,39.96181052,-90.75041256,4238,2437,6675
17011,Bureau ,Illinois,41.40412583,-89.52866709,16437,16944,33381
17013,Calhoun ,Illinois,39.16924303,-90.66753074,2435,2423,4858
17015,Carroll ,Illinois,42.06868734,-89.93439025,7229,7333,14562
17017,Cass ,Illinois,39.97354524,-90.2474008,6353,6312,12665
17019,Champaign ,Illinois,40.14009651,-88.19916001,104513,104935,209448
17021,Christian ,Illinois,39.54583199,-89.27725285,16818,16413,33231
17023,Clark ,Illinois,39.33359041,-87.78771906,7824,8012,15836
17025,Clay ,Illinois,38.75416039,-88.49022977,6586,6752,13338
17027,Clinton ,Illinois,38.60645251,-89.42248618,19551,18077,37628
17029,Coles ,Illinois,39.52027962,-88.22179644,24999,26737,51736
17031,Cook ,Illinois,41.84012633,-87.81683062,2534640,2689079,5223719
17033,Crawford ,Illinois,39.00269711,-87.75956141,9910,9178,19088
17035,Cumberland ,Illinois,39.27334187,-88.24018523,5455,5410,10865
17037,DeKalb ,Illinois,41.89352938,-88.77031406,51580,52620,104200
17039,De Witt ,Illinois,40.17461502,-88.90407555,8015,8027,16042
17041,Douglas ,Illinois,39.76945694,-88.21737067,9748,9966,19714
17043,DuPage ,Illinois,41.85195268,-88.08559583,457178,474565,931743
17045,Edgar ,Illinois,39.67855189,-87.74559247,8617,8922,17539
17047,Edwards ,Illinois,38.41654373,-88.05327845,3231,3276,6507
17049,Effingham ,Illinois,39.05979761,-88.5898601,16971,17203,34174
17051,Fayette ,Illinois,39.00018312,-89.02413055,11580,10144,21724
17053,Ford ,Illinois,40.59716807,-88.22329551,6616,6782,13398
17055,Franklin ,Illinois,37.99227779,-88.92413726,19285,19842,39127
17057,Fulton ,Illinois,40.4727878,-90.20746963,18496,16922,35418
17059,Gallatin ,Illinois,37.76274364,-88.23044404,2472,2685,5157
17061,Greene ,Illinois,39.35621703,-90.39046153,6668,6550,13218
17063,Grundy ,Illinois,41.28511112,-88.41846874,25241,25268,50509
17065,Hamilton ,Illinois,38.08154031,-88.53910016,4018,4203,8221
17067,Hancock ,Illinois,40.40374092,-91.16474814,9008,9104,18112
17069,Hardin ,Illinois,37.51821568,-88.26687347,1976,2033,4009
17071,Henderson ,Illinois,40.81803658,-90.92510329,3369,3515,6884
17073,Henry ,Illinois,41.35313699,-90.13143102,24536,24928,49464
17075,Iroquois ,Illinois,40.74724324,-87.82433851,13751,14418,28169
17077,Jackson ,Illinois,37.78514443,-89.38212877,28989,29562,58551
17079,Jasper ,Illinois,39.01006379,-88.15384992,4809,4789,9598
17081,Jefferson ,Illinois,38.30051395,-88.92401752,19567,18602,38169
17083,Jersey ,Illinois,39.08568408,-90.35668524,10841,11228,22069
17085,Jo Daviess ,Illinois,42.36575465,-90.21249872,10956,10878,21834
17087,Johnson ,Illinois,37.45962932,-88.88092569,7015,5587,12602
17089,Kane ,Illinois,41.93884403,-88.4286391,264211,266628,530839
17091,Kankakee ,Illinois,41.13771026,-87.86183129,54615,56446,111061
17093,Kendall ,Illinois,41.59056548,-88.42879692,61761,62865,124626
17095,Knox ,Illinois,40.93183774,-90.21323705,25743,25256,50999
17097,Lake ,Illinois,42.32333994,-88.00365403,351343,352276,703619
17099,LaSalle ,Illinois,41.34399455,-88.88594498,55400,55001,110401
17101,Lawrence ,Illinois,38.7199557,-87.72678065,8919,7270,16189
17103,Lee ,Illinois,41.74619394,-89.30038807,18326,16201,34527
17105,Livingston ,Illinois,40.8915709,-88.55771847,18614,17710,36324
17107,Logan ,Illinois,40.12455659,-89.36753852,14183,15024,29207
17109,McDonough ,Illinois,40.45619404,-90.67791395,15009,15866,30875
17111,McHenry ,Illinois,42.32442428,-88.45233584,153382,154407,307789
17113,McLean ,Illinois,40.49087527,-88.84732725,84245,88974,173219
17115,Macon ,Illinois,39.85998989,-88.96155998,51062,55450,106512
17117,Macoupin ,Illinois,39.26100417,-89.92443171,22602,23117,45719
17119,Madison ,Illinois,38.82986718,-89.90513715,129718,135952,265670
17121,Marion ,Illinois,38.64959343,-88.91898307,18726,19358,38084
17123,Marshall ,Illinois,41.03315746,-89.3447805,5874,5920,11794
17125,Mason ,Illinois,40.23963203,-89.91683128,6838,6940,13778
17127,Massac ,Illinois,37.21896984,-88.70772194,6794,7636,14430
17129,Menard ,Illinois,40.02739238,-89.80219185,6043,6324,12367
17131,Mercer ,Illinois,41.2053391,-90.74144592,7798,7895,15693
17133,Monroe ,Illinois,38.27845838,-90.17728333,16691,17245,33936
17135,Montgomery ,Illinois,39.23103312,-89.47888818,15145,13864,29009
17137,Morgan ,Illinois,39.71555614,-90.20146646,17298,17128,34426
17139,Moultrie ,Illinois,39.64147354,-88.61929702,7172,7531,14703
17141,Ogle ,Illinois,42.0426469,-89.32064358,25614,25714,51328
17143,Peoria ,Illinois,40.78804569,-89.75996274,89387,95076,184463
17145,Perry ,Illinois,38.08375245,-89.3670021,11767,9617,21384
17147,Piatt ,Illinois,40.01034007,-88.59110643,8080,8347,16427
17149,Pike ,Illinois,39.62250378,-90.88629694,7815,7939,15754
17151,Pope ,Illinois,37.41269436,-88.56152357,2349,1900,4249
17153,Pulaski ,Illinois,37.2228826,-89.12658246,2747,2864,5611
17155,Putnam ,Illinois,41.20447692,-89.28576115,2959,2787,5746
17157,Randolph ,Illinois,38.05210441,-89.82521231,18019,14527,32546
17159,Richland ,Illinois,38.71241556,-88.085109,7809,8072,15881
17161,Rock Island ,Illinois,41.4673202,-90.56737502,71596,73679,145275
17163,St. Clair ,Illinois,38.47033003,-89.92838112,127237,136226,263463
17165,Saline ,Illinois,37.75317245,-88.54075228,11962,12269,24231
17167,Sangamon ,Illinois,39.75816618,-89.6588769,94876,102785,197661
17169,Schuyler ,Illinois,40.15802995,-90.61507354,3701,3363,7064
17171,Scott ,Illinois,39.64412403,-90.47470013,2460,2587,5047
17173,Shelby ,Illinois,39.39113855,-88.80553886,10791,11041,21832
17175,Stark ,Illinois,41.09333903,-89.79747276,2716,2784,5500
17177,Stephenson ,Illinois,42.35172178,-89.66236402,21986,23447,45433
17179,Tazewell ,Illinois,40.50752986,-89.51341811,65987,67865,133852
17181,Union ,Illinois,37.47123279,-89.25511205,8592,8535,17127
17183,Vermilion ,Illinois,40.18341644,-87.73281471,38967,39440,78407
17185,Wabash ,Illinois,38.44604921,-87.84430347,5666,5907,11573
17187,Warren ,Illinois,40.84881676,-90.61501039,8353,8985,17338
17189,Washington ,Illinois,38.35216945,-89.41047005,7108,7047,14155
17191,Wayne ,Illinois,38.42957655,-88.42556024,8141,8346,16487
17193,White ,Illinois,38.08747726,-88.17955519,6882,7143,14025
17195,Whiteside ,Illinois,41.75627873,-89.91409401,27799,28597,56396
17197,Will ,Illinois,41.4450427,-87.97864242,341816,346881,688697
17199,Williamson ,Illinois,37.73025419,-88.92991759,33607,33692,67299
17201,Winnebago ,Illinois,42.33625892,-89.16086011,139748,146426,286174
17203,Woodford ,Illinois,40.7882182,-89.21112229,19343,19474,38817
18001,Adams ,Indiana,40.74565523,-84.93661598,17561,17634,35195
18003,Allen ,Indiana,41.09088453,-85.06657404,180669,189347,370016
18005,Bartholomew ,Indiana,39.20595128,-85.89759073,41150,40743,81893
18007,Benton ,Indiana,40.60625371,-87.31093166,4326,4341,8667
18009,Blackford ,Indiana,40.47363682,-85.32482248,6037,6092,12129
18011,Boone ,Indiana,40.05079934,-86.46870625,31750,32571,64321
18013,Brown ,Indiana,39.19623154,-86.22737678,7441,7593,15034
18015,Carroll ,Indiana,40.58284721,-86.56349722,10034,9960,19994
18017,Cass ,Indiana,40.76153987,-86.34598335,19082,19002,38084
18019,Clark ,Indiana,38.47717759,-85.70729854,56359,59343,115702
18021,Clay ,Indiana,39.39279543,-87.11576459,12935,13333,26268
18023,Clinton ,Indiana,40.30169518,-86.47514275,15986,16315,32301
18025,Crawford ,Indiana,38.29238157,-86.45172411,5367,5214,10581
18027,Daviess ,Indiana,38.70240607,-87.0720446,16634,16303,32937
18029,Dearborn ,Indiana,39.14517193,-84.97324274,24764,24737,49501
18031,Decatur ,Indiana,39.30700147,-85.50110908,13202,13350,26552
18033,DeKalb ,Indiana,41.39757021,-84.99905942,21307,21397,42704
18035,Delaware ,Indiana,40.22754556,-85.39689984,55743,59873,115616
18037,Dubois ,Indiana,38.36427304,-86.87981143,21048,21370,42418
18039,Elkhart ,Indiana,41.59739349,-85.8587347,100713,102891,203604
18041,Fayette ,Indiana,39.64002908,-85.17876388,11474,11785,23259
18043,Floyd ,Indiana,38.31893114,-85.90681259,37135,39674,76809
18045,Fountain ,Indiana,40.12089839,-87.24197108,8251,8235,16486
18047,Franklin ,Indiana,39.41486848,-85.06014333,11426,11416,22842
18049,Fulton ,Indiana,41.04697762,-86.26353702,9962,10250,20212
18051,Gibson ,Indiana,38.31185418,-87.58461347,16848,16748,33596
18053,Grant ,Indiana,40.51580008,-85.65471601,31935,35009,66944
18055,Greene ,Indiana,39.03634431,-86.96204482,16033,16262,32295
18057,Hamilton ,Indiana,40.07247955,-86.05202734,154532,161563,316095
18059,Hancock ,Indiana,39.82355246,-85.77325852,36255,37575,73830
18061,Harrison ,Indiana,38.19517153,-86.11130683,19875,19837,39712
18063,Hendricks ,Indiana,39.7695199,-86.50997023,80391,80549,160940
18065,Henry ,Indiana,39.9310632,-85.3964252,25391,23092,48483
18067,Howard ,Indiana,40.48360753,-86.11695939,39852,42535,82387
18069,Huntington ,Indiana,40.82921962,-85.48813053,17875,18503,36378
18071,Jackson ,Indiana,38.9064164,-86.03753973,21822,22116,43938
18073,Jasper ,Indiana,41.02298757,-87.11611834,16699,16750,33449
18075,Jay ,Indiana,40.4379574,-85.00570481,10398,10595,20993
18077,Jefferson ,Indiana,38.78578872,-85.43855044,15333,16904,32237
18079,Jennings ,Indiana,38.9969233,-85.62803436,13925,13802,27727
18081,Johnson ,Indiana,39.48996224,-86.10159622,74349,77215,151564
18083,Knox ,Indiana,38.68906994,-87.41802467,18949,18460,37409
18085,Kosciusko ,Indiana,41.24407151,-85.86071564,39264,39542,78806
18087,LaGrange ,Indiana,41.64262145,-85.42649137,19752,19190,38942
18089,Lake ,Indiana,41.41713854,-87.38221506,235515,251334,486849
18091,LaPorte ,Indiana,41.54598754,-86.73996089,57068,53484,110552
18093,Lawrence ,Indiana,38.84116043,-86.48345736,22558,23061,45619
18095,Madison ,Indiana,40.16161041,-85.71935636,64707,64798,129505
18097,Marion ,Indiana,39.78171119,-86.13847027,455007,489516,944523
18099,Marshall ,Indiana,41.32484017,-86.26175727,23174,23421,46595
18101,Martin ,Indiana,38.70801366,-86.80307337,5155,5055,10210
18103,Miami ,Indiana,40.76945637,-86.04504973,19084,16817,35901
18105,Monroe ,Indiana,39.16091027,-86.52312652,72416,72987,145403
18107,Montgomery ,Indiana,40.04039734,-86.89329764,19442,18834,38276
18109,Morgan ,Indiana,39.48156963,-86.44623079,34447,35280,69727
18111,Newton ,Indiana,40.95583812,-87.39757008,7004,7014,14018
18113,Noble ,Indiana,41.39860284,-85.41749645,23844,23607,47451
18115,Ohio ,Indiana,38.95007879,-84.96509112,2918,2969,5887
18117,Orange ,Indiana,38.54179057,-86.49506132,9727,9820,19547
18119,Owen ,Indiana,39.3128049,-86.83767051,10628,10250,20878
18121,Parke ,Indiana,39.77363464,-87.20637911,8211,8785,16996
18123,Perry ,Indiana,38.07965285,-86.63802268,10222,8919,19141
18125,Pike ,Indiana,38.39878003,-87.23216276,6256,6155,12411
18127,Porter ,Indiana,41.46054623,-87.0672588,83212,84829,168041
18129,Posey ,Indiana,38.02181793,-87.86845961,12787,12802,25589
18131,Pulaski ,Indiana,41.04185368,-86.69879739,6404,6256,12660
18133,Putnam ,Indiana,39.66628078,-86.84499599,19714,17845,37559
18135,Randolph ,Indiana,40.15758774,-85.01144274,12269,12807,25076
18137,Ripley ,Indiana,39.10347557,-85.26236518,14077,14348,28425
18139,Rush ,Indiana,39.61996981,-85.46576015,8185,8519,16704
18141,St. Joseph ,Indiana,41.61665474,-86.28985055,130832,138408,269240
18143,Scott ,Indiana,38.68507422,-85.74748029,11670,12073,23743
18145,Shelby ,Indiana,39.52371531,-85.79166263,21941,22458,44399
18147,Spencer ,Indiana,38.0140964,-87.00766951,10363,10163,20526
18149,Starke ,Indiana,41.28093741,-86.64762763,11302,11639,22941
18151,Steuben ,Indiana,41.64389193,-85.00085916,17542,16932,34474
18153,Sullivan ,Indiana,39.08884213,-87.41471967,11174,9618,20792
18155,Switzerland ,Indiana,38.82619748,-85.03700185,5504,5124,10628
18157,Tippecanoe ,Indiana,40.38861981,-86.89405933,96866,92428,189294
18159,Tipton ,Indiana,40.31134432,-86.05185147,7609,7609,15218
18161,Union ,Indiana,39.62559479,-84.92513791,3514,3639,7153
18163,Vanderburgh ,Indiana,38.0249606,-87.58581621,87676,93637,181313
18165,Vermillion ,Indiana,39.85382699,-87.46398212,7809,7751,15560
18167,Vigo ,Indiana,39.43063558,-87.38997396,54705,52988,107693
18169,Wabash ,Indiana,40.8456437,-85.79399879,15365,16266,31631
18171,Warren ,Indiana,40.34693718,-87.35330189,4124,4123,8247
18173,Warrick ,Indiana,38.09217365,-87.27208737,30409,31519,61928
18175,Washington ,Indiana,38.599998,-86.10530522,13892,13935,27827
18177,Wayne ,Indiana,39.86438236,-85.00983824,32288,34325,66613
18179,Wells ,Indiana,40.72918907,-85.221194,13773,14174,27947
18181,White ,Indiana,40.74975986,-86.86548809,12143,12074,24217
18183,Whitley ,Indiana,41.13938041,-85.50512035,16702,16947,33649
19001,Adair ,Iowa,41.33074049,-94.47096641,3516,3608,7124
19003,Adams ,Iowa,41.02897522,-94.69916586,1854,1872,3726
19005,Allamakee ,Iowa,43.2842824,-91.37805333,7045,6835,13880
19007,Appanoose ,Iowa,40.74317009,-92.86861877,6154,6356,12510
19009,Audubon ,Iowa,41.68460203,-94.90581788,2758,2879,5637
19011,Benton ,Iowa,42.08018646,-92.06574297,12783,12843,25626
19013,Black Hawk ,Iowa,42.47009069,-92.30882457,65309,67700,133009
19015,Boone ,Iowa,42.03650207,-93.93163339,13310,13089,26399
19017,Bremer ,Iowa,42.77458652,-92.31805393,12274,12508,24782
19019,Buchanan ,Iowa,42.47080625,-91.83784663,10451,10674,21125
19021,Buena Vista ,Iowa,42.73549599,-95.1511346,10238,10022,20260
19023,Butler ,Iowa,42.73156851,-92.79018092,7381,7354,14735
19025,Calhoun ,Iowa,42.38518551,-94.64040362,5044,4736,9780
19027,Carroll ,Iowa,42.0362079,-94.8605656,9988,10356,20344
19029,Cass ,Iowa,41.33149982,-94.92783803,6547,6644,13191
19031,Cedar ,Iowa,41.77232044,-91.13243117,9161,9284,18445
19033,Cerro Gordo ,Iowa,43.08155753,-93.26081364,20850,22134,42984
19035,Cherokee ,Iowa,42.73561393,-95.62381555,5796,5672,11468
19037,Chickasaw ,Iowa,43.06005148,-92.3176755,6058,6041,12099
19039,Clarke ,Iowa,41.02901429,-93.7851537,4689,4593,9282
19041,Clay ,Iowa,43.08257226,-95.15093604,8051,8262,16313
19043,Clayton ,Iowa,42.84472017,-91.34142923,8900,8772,17672
19045,Clinton ,Iowa,41.89802868,-90.53196563,23126,24092,47218
19047,Crawford ,Iowa,42.03720375,-95.38198703,8547,8585,17132
19049,Dallas ,Iowa,41.68487012,-94.0397709,41367,42635,84002
19051,Davis ,Iowa,40.74769344,-92.40971356,4398,4487,8885
19053,Decatur ,Iowa,40.73769891,-93.78628401,4017,4027,8044
19055,Delaware ,Iowa,42.47121197,-91.36733449,8689,8569,17258
19057,Des Moines ,Iowa,40.92317786,-91.18147574,19313,20287,39600
19059,Dickinson ,Iowa,43.37791096,-95.15088081,8515,8541,17056
19061,Dubuque ,Iowa,42.46882114,-90.88245689,47744,49058,96802
19063,Emmet ,Iowa,43.37794354,-94.6784286,4770,4781,9551
19065,Fayette ,Iowa,42.86261109,-91.84435518,9998,9931,19929
19067,Floyd ,Iowa,43.05993265,-92.78900648,7766,8092,15858
19069,Franklin ,Iowa,42.7325438,-93.26247472,5117,5128,10245
19071,Fremont ,Iowa,40.74556962,-95.60467614,3470,3498,6968
19073,Greene ,Iowa,42.03624153,-94.39683407,4380,4623,9003
19075,Grundy ,Iowa,42.40186532,-92.79142901,6108,6233,12341
19077,Guthrie ,Iowa,41.68374611,-94.50106212,5335,5339,10674
19079,Hamilton ,Iowa,42.3837507,-93.70679229,7377,7733,15110
19081,Hancock ,Iowa,43.08190167,-93.73427032,5494,5394,10888
19083,Hardin ,Iowa,42.38387388,-93.24039754,8565,8562,17127
19085,Harrison ,Iowa,41.68285868,-95.81683521,6989,7154,14143
19087,Henry ,Iowa,40.9879861,-91.54454205,10125,9801,19926
19089,Howard ,Iowa,43.35675953,-92.31720101,4580,4684,9264
19091,Humboldt ,Iowa,42.77646004,-94.20716003,4651,4915,9566
19093,Ida ,Iowa,42.38689844,-95.51349743,3457,3459,6916
19095,Iowa ,Iowa,41.68632088,-92.06549578,8052,8155,16207
19097,Jackson ,Iowa,42.17173547,-90.57425029,9712,9683,19395
19099,Jasper ,Iowa,41.68602916,-93.05375425,18669,18222,36891
19101,Jefferson ,Iowa,41.0317693,-91.9488887,9112,8965,18077
19103,Johnson ,Iowa,41.67153254,-91.5881044,72765,74236,147001
19105,Jones ,Iowa,42.1212281,-91.13146148,10585,9983,20568
19107,Keokuk ,Iowa,41.3364575,-92.17863867,5202,4998,10200
19109,Kossuth ,Iowa,43.20419581,-94.20671661,7547,7528,15075
19111,Lee ,Iowa,40.64199984,-91.47925471,17371,17170,34541
19113,Linn ,Iowa,42.0789587,-91.59902613,109540,112581,222121
19115,Louisa ,Iowa,41.21852079,-91.25960822,5724,5499,11223
19117,Lucas ,Iowa,41.0293955,-93.32773855,4318,4279,8597
19119,Lyon ,Iowa,43.38053058,-96.21023288,6013,5756,11769
19121,Madison ,Iowa,41.33071142,-94.01554263,8028,7862,15890
19123,Mahaska ,Iowa,41.33521489,-92.64091016,11252,10956,22208
19125,Marion ,Iowa,41.33444371,-93.09944585,16374,16833,33207
19127,Marshall ,Iowa,42.03583447,-92.99878979,20400,19871,40271
19129,Mills ,Iowa,41.03343008,-95.62131843,7516,7441,14957
19131,Mitchell ,Iowa,43.35636379,-92.78901296,5282,5349,10631
19133,Monona ,Iowa,42.05164263,-95.95990054,4283,4513,8796
19135,Monroe ,Iowa,41.02979569,-92.86900423,4064,3799,7863
19137,Montgomery ,Iowa,41.0301471,-95.15635726,4869,5286,10155
19139,Muscatine ,Iowa,41.48392136,-91.11270703,21476,21474,42950
19141,O'Brien ,Iowa,43.08375704,-95.62491379,6962,6949,13911
19143,Osceola ,Iowa,43.37857912,-95.62366732,3091,3024,6115
19145,Page ,Iowa,40.73913258,-95.15020277,7922,7441,15363
19147,Palo Alto ,Iowa,43.08208883,-94.67813192,4512,4543,9055
19149,Plymouth ,Iowa,42.73781252,-96.21413283,12288,12751,25039
19151,Pocahontas ,Iowa,42.73416445,-94.67874433,3384,3514,6898
19153,Polk ,Iowa,41.6854991,-93.57353196,233599,240675,474274
19155,Pottawattamie ,Iowa,41.33662283,-95.54229497,45923,47580,93503
19157,Poweshiek ,Iowa,41.68644275,-92.53145279,8990,9615,18605
19159,Ringgold ,Iowa,40.73516519,-94.24398812,2432,2552,4984
19161,Sac ,Iowa,42.38623879,-95.10535234,4818,5050,9868
19163,Scott ,Iowa,41.6370912,-90.62323883,84515,87773,172288
19165,Shelby ,Iowa,41.68509095,-95.31017789,5735,5959,11694
19167,Sioux ,Iowa,43.0826321,-96.17785131,17487,17338,34825
19169,Story ,Iowa,42.03623118,-93.46503839,50484,46438,96922
19171,Tama ,Iowa,42.07981047,-92.5325542,8497,8639,17136
19173,Taylor ,Iowa,40.73739709,-94.69642274,3168,3033,6201
19175,Union ,Iowa,41.02772802,-94.24234883,6063,6390,12453
19177,Van Buren ,Iowa,40.7532181,-91.94996628,3698,3525,7223
19179,Wapello ,Iowa,41.03058137,-92.40946505,17403,17912,35315
19181,Warren ,Iowa,41.33437071,-93.56135411,24118,25243,49361
19183,Washington ,Iowa,41.33560632,-91.71785985,11075,11068,22143
19185,Wayne ,Iowa,40.73949993,-93.32736005,3157,3256,6413
19187,Webster ,Iowa,42.4279449,-94.1817767,18972,17785,36757
19189,Winnebago ,Iowa,43.3775101,-93.73413099,5190,5381,10571
19191,Winneshiek ,Iowa,43.29062002,-91.84367475,10156,10245,20401
19193,Woodbury ,Iowa,42.38970362,-96.04477464,50496,51902,102398
19195,Worth ,Iowa,43.37737598,-93.26085344,3754,3735,7489
19197,Wright ,Iowa,42.7330839,-93.7351375,6383,6421,12804
20001,Allen ,Kansas,37.88572095,-95.3013594,6281,6349,12630
20003,Anderson ,Kansas,38.21418084,-95.293339,3932,3920,7852
20005,Atchison ,Kansas,39.53175193,-95.31348731,7949,8414,16363
20007,Barber ,Kansas,37.22885963,-98.68482282,2356,2377,4733
20009,Barton ,Kansas,38.4789632,-98.75645855,13362,13429,26791
20011,Bourbon ,Kansas,37.85520327,-94.84932869,7243,7459,14702
20013,Brown ,Kansas,39.82648788,-95.5642076,4685,4979,9664
20015,Butler ,Kansas,37.78123819,-96.8390418,33539,32929,66468
20017,Chase ,Kansas,38.30203656,-96.59394881,1340,1305,2645
20019,Chautauqua ,Kansas,37.15002546,-96.24538277,1757,1610,3367
20021,Cherokee ,Kansas,37.16932439,-94.84628642,9998,10333,20331
20023,Cheyenne ,Kansas,39.7858685,-101.7312939,1320,1357,2677
20025,Clark ,Kansas,37.23551254,-99.82030399,1037,1016,2053
20027,Clay ,Kansas,39.34972288,-97.16517646,4078,4064,8142
20029,Cloud ,Kansas,39.48029328,-97.64925787,4523,4537,9060
20031,Coffey ,Kansas,38.23686351,-95.7341048,4195,4101,8296
20033,Comanche ,Kansas,37.19126297,-99.27184409,912,868,1780
20035,Cowley ,Kansas,37.23770919,-96.83752845,17915,17676,35591
20037,Crawford ,Kansas,37.50731648,-94.85181559,19527,19581,39108
20039,Decatur ,Kansas,39.78473751,-100.4599391,1419,1462,2881
20041,Dickinson ,Kansas,38.8664868,-97.15269783,9555,9449,19004
20043,Doniphan ,Kansas,39.7880604,-95.14679869,3960,3776,7736
20045,Douglas ,Kansas,38.88466799,-95.29259106,59067,60252,119319
20047,Edwards ,Kansas,37.88761461,-99.3121571,1494,1431,2925
20049,Elk ,Kansas,37.45368647,-96.24415485,1258,1304,2562
20051,Ellis ,Kansas,38.91473313,-99.31726626,14394,14484,28878
20053,Ellsworth ,Kansas,38.69663853,-98.20476048,3654,2639,6293
20055,Finney ,Kansas,38.04428211,-100.7369985,18940,18017,36957
20057,Ford ,Kansas,37.6917175,-99.88795654,17896,16588,34484
20059,Franklin ,Kansas,38.56453053,-95.28594747,12567,12996,25563
20061,Geary ,Kansas,39.00241626,-96.75253039,18540,16355,34895
20063,Gove ,Kansas,38.91609174,-100.4829667,1298,1321,2619
20065,Graham ,Kansas,39.34972719,-99.88322903,1290,1255,2545
20067,Grant ,Kansas,37.56226603,-101.308018,3988,3628,7616
20069,Gray ,Kansas,37.73818203,-100.4378836,3025,3012,6037
20071,Greeley ,Kansas,38.48056391,-101.8060441,581,619,1200
20073,Greenwood ,Kansas,37.87782471,-96.23261222,3106,3050,6156
20075,Hamilton ,Kansas,37.999123,-101.7912406,1353,1263,2616
20077,Harper ,Kansas,37.19162258,-98.07548313,2884,2789,5673
20079,Harvey ,Kansas,38.04321376,-97.42723286,17200,17355,34555
20081,Haskell ,Kansas,37.56222283,-100.8711794,2006,2041,4047
20083,Hodgeman ,Kansas,38.08749317,-99.89792613,941,901,1842
20085,Jackson ,Kansas,39.41682464,-95.79366875,6642,6676,13318
20087,Jefferson ,Kansas,39.23576285,-95.38343919,9581,9307,18888
20089,Jewell ,Kansas,39.78473319,-98.21833955,1482,1434,2916
20091,Johnson ,Kansas,38.88376637,-94.82231677,286987,298515,585502
20093,Kearny ,Kansas,38.0002325,-101.319883,1934,1998,3932
20095,Kingman ,Kansas,37.55889838,-98.13633587,3749,3721,7470
20097,Kiowa ,Kansas,37.55822974,-99.28607727,1234,1292,2526
20099,Labette ,Kansas,37.19130785,-95.2975707,10070,10297,20367
20101,Lane ,Kansas,38.48133334,-100.4664251,850,792,1642
20103,Leavenworth ,Kansas,39.19930867,-95.03798734,42933,37109,80042
20105,Lincoln ,Kansas,39.04530869,-98.20769053,1585,1512,3097
20107,Linn ,Kansas,38.21226067,-94.84297032,4800,4835,9635
20109,Logan ,Kansas,38.91730386,-101.1484097,1398,1412,2810
20111,Lyon ,Kansas,38.45619845,-96.15264733,16260,17039,33299
20113,McPherson ,Kansas,38.39165317,-97.64801952,14159,14471,28630
20115,Marion ,Kansas,38.35886741,-97.09688687,5971,6061,12032
20117,Marshall ,Kansas,39.78356676,-96.52294061,4924,4874,9798
20119,Meade ,Kansas,37.23813195,-100.366251,2129,2132,4261
20121,Miami ,Kansas,38.56353191,-94.83809568,16384,16743,33127
20123,Mitchell ,Kansas,39.39326642,-98.20936979,3163,3059,6222
20125,Montgomery ,Kansas,37.19252119,-95.74287901,16410,16560,32970
20127,Morris ,Kansas,38.68741558,-96.64990012,2753,2813,5566
20129,Morton ,Kansas,37.19138845,-101.7992491,1449,1389,2838
20131,Nemaha ,Kansas,39.78341152,-96.01408048,5119,4985,10104
20133,Neosho ,Kansas,37.55849543,-95.30679411,7923,8202,16125
20135,Ness ,Kansas,38.47942841,-99.91615277,1493,1462,2955
20137,Norton ,Kansas,39.78438555,-99.90348541,3036,2450,5486
20139,Osage ,Kansas,38.65232091,-95.72690732,7968,7914,15882
20141,Osborne ,Kansas,39.35033034,-98.76794728,1807,1796,3603
20143,Ottawa ,Kansas,39.13253162,-97.65021154,3043,2859,5902
20145,Pawnee ,Kansas,38.18132473,-99.23672224,3769,2940,6709
20147,Phillips ,Kansas,39.78456374,-99.34700886,2648,2760,5408
20149,Pottawatomie ,Kansas,39.37900505,-96.34237183,11746,11799,23545
20151,Pratt ,Kansas,37.64773178,-98.73962276,4785,4797,9582
20153,Rawlins ,Kansas,39.78518766,-101.0758505,1286,1223,2509
20155,Reno ,Kansas,37.95295885,-98.08598674,31775,31326,63101
20157,Republic ,Kansas,39.82776407,-97.65061755,2271,2415,4686
20159,Rice ,Kansas,38.34717595,-98.20098737,4844,4918,9762
20161,Riley ,Kansas,39.29656769,-96.73515679,39909,35387,75296
20163,Rooks ,Kansas,39.35022578,-99.32501192,2469,2649,5118
20165,Rush ,Kansas,38.5231279,-99.30915301,1521,1581,3102
20167,Russell ,Kansas,38.91480564,-98.76238719,3452,3525,6977
20169,Saline ,Kansas,38.78381121,-97.64995459,27375,27602,54977
20171,Scott ,Kansas,38.4821737,-100.9068598,2460,2489,4949
20173,Sedgwick ,Kansas,37.68476832,-97.46098502,253201,258863,512064
20175,Seward ,Kansas,37.19332916,-100.8513444,11601,11091,22692
20177,Shawnee ,Kansas,39.04151431,-95.7565293,86327,91957,178284
20179,Sheridan ,Kansas,39.35034744,-100.4418395,1275,1231,2506
20181,Sherman ,Kansas,39.35144906,-101.7199841,3003,2963,5966
20183,Smith ,Kansas,39.78516694,-98.78546973,1809,1854,3663
20185,Stafford ,Kansas,38.03098114,-98.71742594,2157,2057,4214
20187,Stanton ,Kansas,37.56300498,-101.7842167,1055,1008,2063
20189,Stevens ,Kansas,37.19233949,-101.312059,2882,2804,5686
20191,Sumner ,Kansas,37.23731237,-97.47654277,11581,11627,23208
20193,Thomas ,Kansas,39.35091755,-101.0555604,3816,4008,7824
20195,Trego ,Kansas,38.91430951,-99.87283477,1450,1408,2858
20197,Wabaunsee ,Kansas,38.95326993,-96.20499592,3497,3391,6888
20199,Wallace ,Kansas,38.91668121,-101.763616,790,785,1575
20201,Washington ,Kansas,39.78417867,-97.08753439,2844,2681,5525
20203,Wichita ,Kansas,38.48205352,-101.3473839,1019,1124,2143
20205,Wilson ,Kansas,37.55926513,-95.74341897,4318,4462,8780
20207,Woodson ,Kansas,37.88669688,-95.74013436,1583,1587,3170
20209,Wyandotte ,Kansas,39.11461544,-94.76455165,81294,83051,164345
21001,Adair ,Kentucky,37.10417006,-85.28062,9525,9716,19241
21003,Allen ,Kentucky,36.75125145,-86.19041519,10339,10455,20794
21005,Anderson ,Kentucky,38.00392065,-84.99099658,10873,11341,22214
21007,Ballard ,Kentucky,37.05848196,-88.99925589,3992,4098,8090
21009,Barren ,Kentucky,36.96558592,-85.93366216,21165,22515,43680
21011,Bath ,Kentucky,38.14495217,-83.74267657,6096,6172,12268
21013,Bell ,Kentucky,36.730646,-83.67408276,13325,13863,27188
21015,Boone ,Kentucky,38.96985577,-84.7278378,64061,65034,129095
21017,Bourbon ,Kentucky,38.20673452,-84.21715057,9670,10474,20144
21019,Boyd ,Kentucky,38.35957259,-82.68775351,23958,24133,48091
21021,Boyle ,Kentucky,37.62438277,-84.86684215,14903,15010,29913
21023,Bracken ,Kentucky,38.68879489,-84.09014459,4183,4123,8306
21025,Breathitt ,Kentucky,37.52161567,-83.32406325,6577,6539,13116
21027,Breckinridge ,Kentucky,37.77338938,-86.4293375,10088,9992,20080
21029,Bullitt ,Kentucky,37.97007363,-85.69586026,39627,39839,79466
21031,Butler ,Kentucky,37.2072845,-86.68162334,6412,6333,12745
21033,Caldwell ,Kentucky,37.14540715,-87.86786378,6168,6559,12727
21035,Calloway ,Kentucky,36.62103517,-88.27224811,18818,19958,38776
21037,Campbell ,Kentucky,38.94651469,-84.37951741,45124,47143,92267
21039,Carlisle ,Kentucky,36.85320008,-88.97098354,2344,2497,4841
21041,Carroll ,Kentucky,38.66783831,-85.1235738,5455,5256,10711
21043,Carter ,Kentucky,38.31818559,-83.04953875,13437,13853,27290
21045,Casey ,Kentucky,37.32232537,-84.9283212,7738,8058,15796
21047,Christian ,Kentucky,36.89416887,-87.49045444,38411,33852,72263
21049,Clark ,Kentucky,37.97082137,-84.14741622,17573,18299,35872
21051,Clay ,Kentucky,37.15969564,-83.71464309,10827,9794,20621
21053,Clinton ,Kentucky,36.72744165,-85.13617383,5084,5127,10211
21055,Crittenden ,Kentucky,37.35272341,-88.09719713,4593,4490,9083
21057,Cumberland ,Kentucky,36.78659786,-85.38851235,3289,3424,6713
21059,Daviess ,Kentucky,37.73178564,-87.08726981,48742,51195,99937
21061,Edmonson ,Kentucky,37.20879863,-86.23842222,6093,6029,12122
21063,Elliott ,Kentucky,38.11790057,-83.09761514,4285,3232,7517
21065,Estill ,Kentucky,37.69244423,-83.96431121,7104,7209,14313
21067,Fayette ,Kentucky,38.04231919,-84.45871292,156453,162281,318734
21069,Fleming ,Kentucky,38.37011818,-83.69665601,7146,7333,14479
21071,Floyd ,Kentucky,37.55711905,-82.74570557,18070,18856,36926
21073,Franklin ,Kentucky,38.23915254,-84.87706177,24390,25906,50296
21075,Fulton ,Kentucky,36.55404203,-89.18736232,3102,3108,6210
21077,Gallatin ,Kentucky,38.75687068,-84.85932837,4473,4230,8703
21079,Garrard ,Kentucky,37.63959984,-84.53766514,8475,8853,17328
21081,Grant ,Kentucky,38.64881434,-84.62458221,12318,12597,24915
21083,Graves ,Kentucky,36.72310322,-88.65120022,18348,18946,37294
21085,Grayson ,Kentucky,37.46081386,-86.34391608,13073,13105,26178
21087,Green ,Kentucky,37.26403739,-85.55312116,5393,5630,11023
21089,Greenup ,Kentucky,38.54569292,-82.92234465,17411,18354,35765
21091,Hancock ,Kentucky,37.8414909,-86.77791284,4494,4225,8719
21093,Hardin ,Kentucky,37.69792375,-85.96344817,53723,54372,108095
21095,Harlan ,Kentucky,36.85694551,-83.21799386,13132,14002,27134
21097,Harrison ,Kentucky,38.4418152,-84.33136382,9146,9522,18668
21099,Hart ,Kentucky,37.29993003,-85.88469126,9166,9461,18627
21101,Henderson ,Kentucky,37.79580395,-87.57303115,22328,23809,46137
21103,Henry ,Kentucky,38.4484671,-85.11891597,7813,8001,15814
21105,Hickman ,Kentucky,36.67812957,-88.97614455,2133,2435,4568
21107,Hopkins ,Kentucky,37.30883958,-87.54083661,22219,23445,45664
21109,Jackson ,Kentucky,37.41976588,-84.00575272,6655,6718,13373
21111,Jefferson ,Kentucky,38.18717511,-85.65913786,370844,396310,767154
21113,Jessamine ,Kentucky,37.87207148,-84.58095198,25479,26943,52422
21115,Johnson ,Kentucky,37.84664101,-82.8315147,11200,11643,22843
21117,Kenton ,Kentucky,38.93339565,-84.53331132,81430,83258,164688
21119,Knott ,Kentucky,37.35404719,-82.95414137,7693,7820,15513
21121,Knox ,Kentucky,36.89064843,-83.85404403,15330,16137,31467
21123,Larue ,Kentucky,37.54579346,-85.6979283,7027,7129,14156
21125,Laurel ,Kentucky,37.11067362,-84.11780203,29412,30768,60180
21127,Lawrence ,Kentucky,38.06787567,-82.73475458,7898,7885,15783
21129,Lee ,Kentucky,37.59480249,-83.71619577,3501,3250,6751
21131,Leslie ,Kentucky,37.09406862,-83.38112755,5067,5405,10472
21133,Letcher ,Kentucky,37.12117501,-82.8553129,11087,11589,22676
21135,Lewis ,Kentucky,38.5315828,-83.3780685,6714,6776,13490
21137,Lincoln ,Kentucky,37.45536765,-84.66084397,11981,12477,24458
21139,Livingston ,Kentucky,37.20962302,-88.3537206,4626,4637,9263
21141,Logan ,Kentucky,36.85968526,-86.87891917,13154,13695,26849
21143,Lyon ,Kentucky,37.01910069,-88.08316022,4496,3690,8186
21145,McCracken ,Kentucky,37.05395743,-88.71265237,31193,34091,65284
21147,McCreary ,Kentucky,36.7371207,-84.48422153,9613,8022,17635
21149,McLean ,Kentucky,37.52919291,-87.26360911,4602,4729,9331
21151,Madison ,Kentucky,37.72018252,-84.27800423,43737,45963,89700
21153,Magoffin ,Kentucky,37.70646879,-83.06491971,6348,6318,12666
21155,Marion ,Kentucky,37.55253601,-85.2696361,9751,9481,19232
21157,Marshall ,Kentucky,36.88344279,-88.3293727,15341,15825,31166
21159,Martin ,Kentucky,37.80157694,-82.51323011,6583,5336,11919
21161,Mason ,Kentucky,38.59518639,-83.82408709,8485,8668,17153
21163,Meade ,Kentucky,37.96974097,-86.21697477,14352,13974,28326
21165,Menifee ,Kentucky,37.94138815,-83.59886645,3421,2984,6405
21167,Mercer ,Kentucky,37.81104053,-84.87445675,10597,10919,21516
21169,Metcalfe ,Kentucky,36.99053102,-85.62922748,4923,5081,10004
21171,Monroe ,Kentucky,36.71215467,-85.71648017,5370,5264,10634
21173,Montgomery ,Kentucky,38.03351826,-83.91314317,13541,14218,27759
21175,Morgan ,Kentucky,37.92228294,-83.25888589,7425,5860,13285
21177,Muhlenberg ,Kentucky,37.21578975,-87.14203055,15286,15795,31081
21179,Nelson ,Kentucky,37.805154,-85.46595802,22492,22896,45388
21181,Nicholas ,Kentucky,38.33555368,-84.01530138,3369,3731,7100
21183,Ohio ,Kentucky,37.47819577,-86.84887835,11960,12111,24071
21185,Oldham ,Kentucky,38.39943805,-85.44833916,34328,31046,65374
21187,Owen ,Kentucky,38.51964953,-84.82810334,5304,5437,10741
21189,Owsley ,Kentucky,37.41919964,-83.68309732,1947,2516,4463
21191,Pendleton ,Kentucky,38.695637,-84.36025442,7360,7160,14520
21193,Perry ,Kentucky,37.24429917,-83.22147077,13273,13644,26917
21195,Pike ,Kentucky,37.4690704,-82.39582319,29507,30976,60483
21197,Powell ,Kentucky,37.83112678,-83.82373372,6048,6273,12321
21199,Pulaski ,Kentucky,37.10386539,-84.57725002,31517,32628,64145
21201,Robertson ,Kentucky,38.5188089,-84.05203189,1147,996,2143
21203,Rockcastle ,Kentucky,37.36505827,-84.31600989,8170,8657,16827
21205,Rowan ,Kentucky,38.1962554,-83.42110798,11763,12736,24499
21207,Russell ,Kentucky,36.99109064,-85.05865143,8688,9072,17760
21209,Scott ,Kentucky,38.29154578,-84.58392157,26516,27001,53517
21211,Shelby ,Kentucky,38.21545335,-85.19477852,22613,24173,46786
21213,Simpson ,Kentucky,36.74195036,-86.58224359,8926,9137,18063
21215,Spencer ,Kentucky,38.03252017,-85.32782654,9277,8969,18246
21217,Taylor ,Kentucky,37.3664657,-85.32792647,12525,12975,25500
21219,Todd ,Kentucky,36.83568225,-87.17923393,6049,6301,12350
21221,Trigg ,Kentucky,36.80635868,-87.87335278,7077,7267,14344
21223,Trimble ,Kentucky,38.61299711,-85.33754103,4238,4399,8637
21225,Union ,Kentucky,37.65846199,-87.94534462,7597,7205,14802
21227,Warren ,Kentucky,36.99357345,-86.42380703,61873,64554,126427
21229,Washington ,Kentucky,37.75338014,-85.17476537,5865,6154,12019
21231,Wayne ,Kentucky,36.8012791,-84.82862313,10154,10455,20609
21233,Webster ,Kentucky,37.51844353,-87.68316317,6457,6698,13155
21235,Whitley ,Kentucky,36.75809682,-84.14517967,17668,18421,36089
21237,Wolfe ,Kentucky,37.73931923,-83.49316616,3596,3627,7223
21239,Woodford ,Kentucky,38.04238651,-84.74360194,12564,13533,26097
22001,Acadia Parish,Louisiana,30.29053648,-92.41198415,30491,32077,62568
22003,Allen Parish,Louisiana,30.65291854,-92.8279186,14638,11023,25661
22005,Ascension Parish,Louisiana,30.20354432,-90.91130991,59998,61178,121176
22007,Assumption Parish,Louisiana,29.90078262,-91.06258775,11005,11709,22714
22009,Avoyelles Parish,Louisiana,31.07623772,-92.00138568,20607,20275,40882
22011,Beauregard Parish,Louisiana,30.64845866,-93.34336855,18712,18057,36769
22013,Bienville Parish,Louisiana,32.34717073,-93.05597977,6523,7145,13668
22015,Bossier Parish,Louisiana,32.67892599,-93.60504359,62349,63782,126131
22017,Caddo Parish,Louisiana,32.58007092,-93.8823288,117828,130533,248361
22019,Calcasieu Parish,Louisiana,30.22927163,-93.35801271,97603,102579,200182
22021,Caldwell Parish,Louisiana,32.09230989,-92.11655892,5277,4719,9996
22023,Cameron Parish,Louisiana,29.8754432,-93.1938179,3357,3511,6868
22025,Catahoula Parish,Louisiana,31.66617985,-91.84706124,5214,4679,9893
22027,Claiborne Parish,Louisiana,32.82263508,-92.99575993,9205,6948,16153
22029,Concordia Parish,Louisiana,31.44585576,-91.64006958,10210,9811,20021
22031,De Soto Parish,Louisiana,32.05543535,-93.73724616,13172,14044,27216
22033,East Baton Rouge Parish,Louisiana,30.53825126,-91.09560315,212778,231316,444094
22035,East Carroll Parish,Louisiana,32.73255145,-91.23505403,4373,2852,7225
22037,East Feliciana Parish,Louisiana,30.84510545,-91.04552429,10715,8784,19499
22039,Evangeline Parish,Louisiana,30.72894984,-92.40590575,17142,16494,33636
22041,Franklin Parish,Louisiana,32.13321369,-91.67377188,9981,10341,20322
22043,Grant Parish,Louisiana,31.5996974,-92.55950489,12658,9690,22348
22045,Iberia Parish,Louisiana,29.89652871,-91.72998354,35508,37183,72691
22047,Iberville Parish,Louisiana,30.25848996,-91.34933844,16661,16295,32956
22049,Jackson Parish,Louisiana,32.30205969,-92.55778384,8080,7846,15926
22051,Jefferson Parish,Louisiana,29.7871678,-90.12738939,211175,224125,435300
22053,Jefferson Davis Parish,Louisiana,30.26770296,-92.81412241,15590,15877,31467
22055,Lafayette Parish,Louisiana,30.20674465,-92.06387515,117169,122922,240091
22057,Lafourche Parish,Louisiana,29.56623879,-90.42577006,48261,49953,98214
22059,LaSalle Parish,Louisiana,31.67670104,-92.16040875,7730,7219,14949
22061,Lincoln Parish,Louisiana,32.60161626,-92.66483583,23041,24315,47356
22063,Livingston Parish,Louisiana,30.44014952,-90.72789748,67836,70275,138111
22065,Madison Parish,Louisiana,32.36440307,-91.24262373,5708,5764,11472
22067,Morehouse Parish,Louisiana,32.82021594,-91.80178763,12444,13548,25992
22069,Natchitoches Parish,Louisiana,31.72353781,-93.09622461,18622,20341,38963
22071,Orleans Parish,Louisiana,30.0686862,-89.92883167,185377,204271,389648
22073,Ouachita Parish,Louisiana,32.47832375,-92.15486594,74853,81222,156075
22075,Plaquemines Parish,Louisiana,29.4405264,-89.60968112,11617,11756,23373
22077,Pointe Coupee Parish,Louisiana,30.7093814,-91.60078731,10614,11544,22158
22079,Rapides Parish,Louisiana,31.19862998,-92.53318687,63681,67865,131546
22081,Red River Parish,Louisiana,32.09313295,-93.33986542,4067,4551,8618
22083,Richland Parish,Louisiana,32.41780311,-91.76347507,9952,10522,20474
22085,Sabine Parish,Louisiana,31.56400056,-93.55459812,11929,12159,24088
22087,St. Bernard Parish,Louisiana,29.86925543,-89.5551532,22402,23292,45694
22089,St. Charles Parish,Louisiana,29.90547792,-90.35819454,26121,26603,52724
22091,St. Helena Parish,Louisiana,30.82199018,-90.71034058,5039,5372,10411
22093,St. James Parish,Louisiana,30.0263033,-90.79633115,10266,11091,21357
22095,St. John the Baptist Parish,Louisiana,30.12646199,-90.47089984,21308,22138,43446
22097,St. Landry Parish,Louisiana,30.59884607,-92.00586173,40151,43298,83449
22099,St. Martin Parish,Louisiana,30.12908921,-91.60830334,26452,27300,53752
22101,St. Mary Parish,Louisiana,29.70465723,-91.44315054,25607,26127,51734
22103,St. Tammany Parish,Louisiana,30.41022617,-89.9583012,122347,129746,252093
22105,Tangipahoa Parish,Louisiana,30.62662974,-90.40567708,63237,67267,130504
22107,Tensas Parish,Louisiana,32.00171085,-91.3400997,2296,2370,4666
22109,Terrebonne Parish,Louisiana,29.41477471,-90.86634415,55305,57282,112587
22111,Union Parish,Louisiana,32.8318447,-92.3747932,11132,11343,22475
22113,Vermilion Parish,Louisiana,29.84654087,-92.32380996,29121,30746,59867
22115,Vernon Parish,Louisiana,31.10831137,-93.18421037,27126,23881,51007
22117,Washington Parish,Louisiana,30.85332285,-90.04045257,22963,23494,46457
22119,Webster Parish,Louisiana,32.71346949,-93.33497408,19242,20389,39631
22121,West Baton Rouge Parish,Louisiana,30.46341284,-91.31273518,12863,12997,25860
22123,West Carroll Parish,Louisiana,32.78849999,-91.45676951,5704,5476,11180
22125,West Feliciana Parish,Louisiana,30.87980394,-91.4200066,9802,5575,15377
22127,Winn Parish,Louisiana,31.94425843,-92.63668641,7733,6761,14494
23001,Androscoggin ,Maine,44.16579102,-70.20647121,52514,54930,107444
23003,Aroostook ,Maine,46.65891616,-68.59890428,33745,34524,68269
23005,Cumberland ,Maine,43.84641179,-70.39879001,141276,149668,290944
23007,Franklin ,Maine,44.9740326,-70.44400818,14651,15368,30019
23009,Hancock ,Maine,44.66419124,-68.35859842,26374,28167,54541
23011,Kennebec ,Maine,44.40911177,-69.76733332,59159,62386,121545
23013,Knox ,Maine,44.14104239,-69.16856931,19701,20122,39823
23015,Lincoln ,Maine,44.06638253,-69.54350467,16624,17443,34067
23017,Oxford ,Maine,44.49987254,-70.75660577,28316,29009,57325
23019,Penobscot ,Maine,45.40063185,-68.64945872,75196,76552,151748
23021,Piscataquis ,Maine,45.8373423,-69.2845937,8440,8447,16887
23023,Sagadahoc ,Maine,43.95977198,-69.85456646,17228,18049,35277
23025,Somerset ,Maine,45.51390922,-69.95890401,25085,25625,50710
23027,Waldo ,Maine,44.50275192,-69.1454058,19347,20071,39418
23029,Washington ,Maine,45.03063661,-67.62879048,15614,16080,31694
23031,York ,Maine,43.47821628,-70.71437648,99029,104073,203102
24001,Allegany ,Maryland,39.6214504,-78.69761749,37646,34331,71977
24003,Anne Arundel ,Maryland,39.0064628,-76.60506838,281176,286520,567696
24005,Baltimore ,Maryland,39.46271143,-76.63929188,392421,435204,827625
24009,Calvert ,Maryland,38.54336128,-76.56867913,45307,45775,91082
24011,Caroline ,Maryland,38.87171302,-75.83155514,16021,16854,32875
24013,Carroll ,Maryland,39.56288409,-77.02254595,82841,84681,167522
24015,Cecil ,Maryland,39.57124104,-75.94073959,51149,51368,102517
24017,Charles ,Maryland,38.5072946,-76.99216185,76071,81600,157671
24019,Dorchester ,Maryland,38.48290909,-76.01254892,15335,16926,32261
24021,Frederick ,Maryland,39.47223039,-77.3980066,122524,125948,248472
24023,Garrett ,Maryland,39.52888601,-79.27293894,14561,14815,29376
24025,Harford ,Maryland,39.5610915,-76.31705649,122763,128262,251025
24027,Howard ,Maryland,39.25072396,-76.93118995,154285,161042,315327
24029,Kent ,Maryland,39.25453706,-76.03992874,9344,10249,19593
24031,Montgomery ,Maryland,39.13633399,-77.20418249,502389,537744,1040133
24033,Prince George's ,Maryland,38.82952707,-76.84727989,436446,469756,906202
24035,Queen Anne's ,Maryland,39.06801418,-76.02027633,24426,24929,49355
24037,St. Mary's ,Maryland,38.30239758,-76.60584716,55552,55979,111531
24039,Somerset ,Maryland,38.11578048,-75.75175602,13833,11904,25737
24041,Talbot ,Maryland,38.77134602,-76.0971001,17626,19585,37211
24043,Washington ,Maryland,39.60360671,-77.81395284,76098,73713,149811
24045,Wicomico ,Maryland,38.37329433,-75.62078298,48535,53637,102172
24047,Worcester ,Maryland,38.21277855,-75.33400403,25283,26281,51564
24510,Baltimore city,Maryland,39.30507927,-76.61444154,288691,326009,614700
25001,Barnstable ,Massachusetts,41.72417861,-70.29149042,102176,111514,213690
25003,Berkshire ,Massachusetts,42.37069926,-73.20634678,61603,65725,127328
25005,Bristol ,Massachusetts,41.79716381,-71.11437747,270624,288281,558905
25007,Dukes ,Massachusetts,41.39608469,-70.65008762,8475,8838,17313
25009,Essex ,Massachusetts,42.67309223,-70.951967,376475,404549,781024
25011,Franklin ,Massachusetts,42.58309255,-72.59183801,34601,36334,70935
25013,Hampden ,Massachusetts,42.13508896,-72.63158231,226555,242561,469116
25015,Hampshire ,Massachusetts,42.3401535,-72.66378583,75426,85733,161159
25017,Middlesex ,Massachusetts,42.48557457,-71.39179841,779666,815526,1595192
25019,Nantucket ,Massachusetts,41.28313946,-70.06919709,5650,5451,11101
25021,Norfolk ,Massachusetts,42.16068851,-71.21110421,335338,362911,698249
25023,Plymouth ,Massachusetts,41.95116262,-70.81141076,249126,263009,512135
25025,Suffolk ,Massachusetts,42.33358904,-71.0708743,382830,408936,791766
25027,Worcester ,Massachusetts,42.35142184,-71.90774265,405434,416846,822280
26001,Alcona ,Michigan,44.68540489,-83.59372645,5224,5140,10364
26003,Alger ,Michigan,46.40864027,-86.60396542,5104,4090,9194
26005,Allegan ,Michigan,42.59127318,-85.88843866,57586,57664,115250
26007,Alpena ,Michigan,45.03486333,-83.62580679,14095,14517,28612
26009,Antrim ,Michigan,44.99907785,-85.14023477,11515,11662,23177
26011,Arenac ,Michigan,44.06465487,-83.89403739,7681,7484,15165
26013,Baraga ,Michigan,46.6626205,-88.36518562,4720,3787,8507
26015,Barry ,Michigan,42.59503952,-85.30895874,30248,29809,60057
26017,Bay ,Michigan,43.70800423,-83.99157753,51486,53300,104786
26019,Benzie ,Michigan,44.63872337,-86.01553792,8743,8809,17552
26021,Berrien ,Michigan,41.95467785,-86.4122676,75737,79070,154807
26023,Branch ,Michigan,41.91613791,-85.05902456,22485,21099,43584
26025,Calhoun ,Michigan,42.2465419,-85.00558482,65782,68691,134473
26027,Cass ,Michigan,41.91536112,-85.99348946,25789,25671,51460
26029,Charlevoix ,Michigan,45.3021535,-85.12633662,12907,13312,26219
26031,Cheboygan ,Michigan,45.44651949,-84.49990074,12720,12738,25458
26033,Chippewa ,Michigan,46.30527018,-84.57768765,20794,17040,37834
26035,Clare ,Michigan,43.98789909,-84.84786305,15159,15457,30616
26037,Clinton ,Michigan,42.9436637,-84.60151723,38528,39368,77896
26039,Crawford ,Michigan,44.68366237,-84.61029577,7060,6776,13836
26041,Delta ,Michigan,45.91911878,-86.9242276,17998,18192,36190
26043,Dickinson ,Michigan,46.00914879,-87.87024586,12754,12816,25570
26045,Eaton ,Michigan,42.59607599,-84.83830305,53353,55802,109155
26047,Emmet ,Michigan,45.52095802,-84.89079686,16307,16732,33039
26049,Genesee ,Michigan,43.02172073,-83.70670935,197382,211979,409361
26051,Gladwin ,Michigan,43.99065809,-84.38827198,12739,12550,25289
26053,Gogebic ,Michigan,46.4088957,-89.69443186,8324,7090,15414
26055,Grand Traverse ,Michigan,44.66876259,-85.5604922,45367,46379,91746
26057,Gratiot ,Michigan,43.29273488,-84.60492496,21961,19106,41067
26059,Hillsdale ,Michigan,41.88778449,-84.59294121,22798,23032,45830
26061,Houghton ,Michigan,46.89776972,-88.6874107,19668,16692,36360
26063,Huron ,Michigan,43.83335678,-83.02323063,15692,15851,31543
26065,Ingham ,Michigan,42.5970992,-84.37354629,140970,148594,289564
26067,Ionia ,Michigan,42.94509622,-85.07460484,34053,30123,64176
26069,Iosco ,Michigan,44.35584286,-83.6358522,12578,12669,25247
26071,Iron ,Michigan,46.20869189,-88.53054536,5595,5617,11212
26073,Isabella ,Michigan,43.6406119,-84.84678503,34371,36404,70775
26075,Jackson ,Michigan,42.24848867,-84.42342721,81205,77708,158913
26077,Kalamazoo ,Michigan,42.2454605,-85.53118546,128025,133548,261573
26079,Kalkaska ,Michigan,44.6846684,-85.09020823,8908,8555,17463
26081,Kent ,Michigan,43.03215075,-85.54929359,316734,326406,643140
26083,Keweenaw ,Michigan,47.62791243,-88.43455699,1111,1019,2130
26085,Lake ,Michigan,43.99011424,-85.8016334,6000,5763,11763
26087,Lapeer ,Michigan,43.09014649,-83.22178479,44842,43360,88202
26089,Leelanau ,Michigan,44.93858767,-85.81179899,10742,10897,21639
26091,Lenawee ,Michigan,41.8951225,-84.06638651,49815,48659,98474
26093,Livingston ,Michigan,42.60291957,-83.91152697,94566,93916,188482
26095,Luce ,Michigan,46.47066022,-85.54436929,3743,2621,6364
26097,Mackinac ,Michigan,46.08022584,-85.08684538,5463,5354,10817
26099,Macomb ,Michigan,42.69553685,-82.9322513,422835,445869,868704
26101,Manistee ,Michigan,44.33300256,-86.05682439,12658,11786,24444
26103,Marquette ,Michigan,46.43135809,-87.64158181,33703,33236,66939
26105,Mason ,Michigan,43.99516735,-86.24997444,14310,14574,28884
26107,Mecosta ,Michigan,43.64077236,-85.3246034,21844,21420,43264
26109,Menominee ,Michigan,45.58003372,-87.55656863,11781,11453,23234
26111,Midland ,Michigan,43.64684327,-84.38811932,40980,42409,83389
26113,Missaukee ,Michigan,44.33738906,-85.09472248,7668,7338,15006
26115,Monroe ,Michigan,41.92868795,-83.53749271,73914,75785,149699
26117,Montcalm ,Michigan,43.31095166,-85.15250861,32595,30614,63209
26119,Montmorency ,Michigan,45.027611,-84.127221,4665,4596,9261
26121,Muskegon ,Michigan,43.29124705,-86.15204777,86083,86960,173043
26123,Newaygo ,Michigan,43.55419013,-85.80092248,24149,23993,48142
26125,Oakland ,Michigan,42.66039551,-83.38580995,610771,640072,1250843
26127,Oceana ,Michigan,43.64093364,-86.26757844,13412,13005,26417
26129,Ogemaw ,Michigan,44.33496373,-84.12644419,10480,10448,20928
26131,Ontonagon ,Michigan,46.66445524,-89.31487563,3054,2914,5968
26133,Osceola ,Michigan,43.98980712,-85.32528706,11738,11494,23232
26135,Oscoda ,Michigan,44.68176697,-84.12977084,4251,4026,8277
26137,Otsego ,Michigan,45.0213899,-84.59896838,12061,12336,24397
26139,Ottawa ,Michigan,42.95984867,-85.99610113,140285,143749,284034
26141,Presque Isle ,Michigan,45.34018978,-83.91760649,6386,6411,12797
26143,Roscommon ,Michigan,44.33556784,-84.61156803,11857,12020,23877
26145,Saginaw ,Michigan,43.33504204,-84.05316963,93581,99197,192778
26147,St. Clair ,Michigan,42.93406661,-82.6805387,79300,80266,159566
26149,St. Joseph ,Michigan,41.91444552,-85.52776353,30259,30638,60897
26151,Sanilac ,Michigan,43.42359717,-82.8201355,20534,20842,41376
26153,Schoolcraft ,Michigan,46.19655666,-86.19965631,3984,4085,8069
26155,Shiawassee ,Michigan,42.95373653,-84.14672752,33801,34692,68493
26157,Tuscola ,Michigan,43.46452228,-83.41688333,26732,26518,53250
26159,Van Buren ,Michigan,42.25130635,-86.01894507,37429,37843,75272
26161,Washtenaw ,Michigan,42.25321807,-83.83876488,181376,184585,365961
26163,Wayne ,Michigan,42.28185696,-83.28210347,847648,913734,1761382
26165,Wexford ,Michigan,44.33833429,-85.57843748,16567,16544,33111
27001,Aitkin ,Minnesota,46.60822844,-93.41542609,8053,7781,15834
27003,Anoka ,Minnesota,45.27325655,-93.24647728,173811,173620,347431
27005,Becker ,Minnesota,46.93464855,-95.67396493,16783,16990,33773
27007,Beltrami ,Minnesota,47.97375423,-94.93765106,22906,23211,46117
27009,Benton ,Minnesota,45.69910576,-93.99882915,19894,19885,39779
27011,Big Stone ,Minnesota,45.42610195,-96.41094242,2477,2539,5016
27013,Blue Earth ,Minnesota,44.03458692,-94.06700987,33323,32999,66322
27015,Brown ,Minnesota,44.24213685,-94.72759343,12653,12558,25211
27017,Carlton ,Minnesota,46.59240866,-92.67703396,18565,16975,35540
27019,Carver ,Minnesota,44.82079018,-93.80259867,49793,50623,100416
27021,Cass ,Minnesota,46.9495938,-94.32537161,14798,14224,29022
27023,Chippewa ,Minnesota,45.02233286,-95.56669432,5959,6051,12010
27025,Chisago ,Minnesota,45.50246011,-92.90833137,28333,26394,54727
27027,Clay ,Minnesota,46.89235047,-96.49064955,31010,31791,62801
27029,Clearwater ,Minnesota,47.57754185,-95.37902556,4504,4308,8812
27031,Cook ,Minnesota,47.90256751,-90.53463546,2632,2679,5311
27033,Cottonwood ,Minnesota,44.00712526,-95.18119515,5662,5710,11372
27035,Crow Wing ,Minnesota,46.48244515,-94.07089871,31966,31889,63855
27037,Dakota ,Minnesota,44.67187042,-93.0654345,205909,212292,418201
27039,Dodge ,Minnesota,44.02260692,-92.86204695,10334,10248,20582
27041,Douglas ,Minnesota,45.93372358,-95.45352828,18607,18596,37203
27043,Faribault ,Minnesota,43.67391956,-93.94792869,6949,6947,13896
27045,Fillmore ,Minnesota,43.67395263,-92.09016617,10491,10397,20888
27047,Freeborn ,Minnesota,43.67380835,-93.3488208,15217,15309,30526
27049,Goodhue ,Minnesota,44.40986492,-92.72257215,23093,23124,46217
27051,Grant ,Minnesota,45.93405115,-96.01217476,3020,2918,5938
27053,Hennepin ,Minnesota,45.00457459,-93.47688798,610530,624948,1235478
27055,Houston ,Minnesota,43.67143647,-91.49288529,9349,9314,18663
27057,Hubbard ,Minnesota,47.10863791,-94.91663733,10550,10312,20862
27059,Isanti ,Minnesota,45.56148675,-93.2951355,19720,19254,38974
27061,Itasca ,Minnesota,47.50951027,-93.63197435,22913,22290,45203
27063,Jackson ,Minnesota,43.67411861,-95.15401904,5069,4978,10047
27065,Kanabec ,Minnesota,45.94518746,-93.2933699,8133,7871,16004
27067,Kandiyohi ,Minnesota,45.15236884,-95.00471728,21430,21228,42658
27069,Kittson ,Minnesota,48.77663057,-96.7828665,2199,2138,4337
27071,Koochiching ,Minnesota,48.24530142,-93.78333507,6327,6317,12644
27073,Lac qui Parle ,Minnesota,44.99547443,-96.17351558,3377,3396,6773
27075,Lake ,Minnesota,47.6409276,-91.44572875,5428,5141,10569
27077,Lake of the Woods ,Minnesota,48.77124932,-94.90456674,2037,1772,3809
27079,Le Sueur ,Minnesota,44.37143504,-93.73009898,14106,13877,27983
27081,Lincoln ,Minnesota,44.4126079,-96.26711247,2855,2852,5707
27083,Lyon ,Minnesota,44.41353259,-95.83901226,12788,13051,25839
27085,McLeod ,Minnesota,44.82355663,-94.27240089,17922,17903,35825
27087,Mahnomen ,Minnesota,47.32530992,-95.8090424,2728,2778,5506
27089,Marshall ,Minnesota,48.35811552,-96.3684452,4761,4631,9392
27091,Martin ,Minnesota,43.67431506,-94.55116401,10068,9896,19964
27093,Meeker ,Minnesota,45.12310434,-94.52732169,11727,11352,23079
27095,Mille Lacs ,Minnesota,45.93802704,-93.63007492,12866,12862,25728
27097,Morrison ,Minnesota,46.01261826,-94.26839131,16639,16310,32949
27099,Mower ,Minnesota,43.6714314,-92.75252927,20045,19557,39602
27101,Murray ,Minnesota,44.02216246,-95.76327372,4170,4183,8353
27103,Nicollet ,Minnesota,44.34988168,-94.24739496,16937,16846,33783
27105,Nobles ,Minnesota,43.67423332,-95.75336596,11236,10603,21839
27107,Norman ,Minnesota,47.3264632,-96.4552898,3324,3235,6559
27109,Olmsted ,Minnesota,44.00375957,-92.40175127,74836,78229,153065
27111,Otter Tail ,Minnesota,46.40880097,-95.70799387,29263,28729,57992
27113,Pennington ,Minnesota,48.06623221,-96.03669991,7054,7130,14184
27115,Pine ,Minnesota,46.12075694,-92.74133481,15648,13481,29129
27117,Pipestone ,Minnesota,44.02300876,-96.25864868,4441,4744,9185
27119,Polk ,Minnesota,47.77386177,-96.40187411,15967,15624,31591
27121,Pope ,Minnesota,45.58600155,-95.4445026,5562,5418,10980
27123,Ramsey ,Minnesota,45.01705737,-93.09961132,263843,277650,541493
27125,Red Lake ,Minnesota,47.87168987,-96.09534974,2034,1974,4008
27127,Redwood ,Minnesota,44.40366443,-95.25383934,7719,7612,15331
27129,Renville ,Minnesota,44.72681384,-94.94711956,7495,7226,14721
27131,Rice ,Minnesota,44.35425702,-93.29668219,33580,32185,65765
27133,Rock ,Minnesota,43.67469049,-96.25320594,4625,4788,9413
27135,Roseau ,Minnesota,48.77511409,-95.81083396,8003,7459,15462
27137,St. Louis ,Minnesota,47.60315654,-92.47063162,100487,99593,200080
27139,Scott ,Minnesota,44.64846543,-93.53589331,71406,71966,143372
27141,Sherburne ,Minnesota,45.4439426,-93.77458965,47673,45558,93231
27143,Sibley ,Minnesota,44.57949766,-94.23212717,7570,7342,14912
27145,Stearns ,Minnesota,45.55214395,-94.61301735,78931,77888,156819
27147,Steele ,Minnesota,44.02234102,-93.22604753,18171,18505,36676
27149,Stevens ,Minnesota,45.58612258,-96.00030566,4910,4874,9784
27151,Swift ,Minnesota,45.28268658,-95.68144096,4726,4685,9411
27153,Todd ,Minnesota,46.07061358,-94.89759096,12563,11877,24440
27155,Traverse ,Minnesota,45.77217847,-96.47159116,1644,1693,3337
27157,Wabasha ,Minnesota,44.28429393,-92.23027086,10779,10721,21500
27159,Wadena ,Minnesota,46.58576477,-94.96939499,6727,6919,13646
27161,Waseca ,Minnesota,44.02211443,-93.5872685,9000,9809,18809
27163,Washington ,Minnesota,45.03869826,-92.88393502,125332,127985,253317
27165,Watonwan ,Minnesota,43.97843767,-94.61407412,5408,5565,10973
27167,Wilkin ,Minnesota,46.35706126,-96.46832595,3215,3128,6343
27169,Winona ,Minnesota,43.98684965,-91.77915639,25191,25656,50847
27171,Wright ,Minnesota,45.17394987,-93.96305477,66913,65832,132745
27173,Yellow Medicine ,Minnesota,44.71624862,-95.86836214,5056,4812,9868
28001,Adams ,Mississippi,31.48288992,-91.35354065,16217,15330,31547
28003,Alcorn ,Mississippi,34.88081004,-88.58026289,18287,18893,37180
28005,Amite ,Mississippi,31.17442643,-90.80441712,6007,6461,12468
28007,Attala ,Mississippi,33.08627828,-89.58150817,8826,9755,18581
28009,Benton ,Mississippi,34.8172935,-89.18846406,4122,4131,8253
28011,Bolivar ,Mississippi,33.79558181,-90.88036126,15365,17227,32592
28013,Calhoun ,Mississippi,33.93646015,-89.33645597,6991,7580,14571
28015,Carroll ,Mississippi,33.44852758,-89.92018118,5116,5013,10129
28017,Chickasaw ,Mississippi,33.92079496,-88.947856,8331,8948,17279
28019,Choctaw ,Mississippi,33.34730044,-89.24837937,4174,4147,8321
28021,Claiborne ,Mississippi,31.97366193,-90.91177432,4312,4808,9120
28023,Clarke ,Mississippi,32.04138036,-88.6894293,7443,8485,15928
28025,Clay ,Mississippi,33.65564608,-88.78154772,9177,10631,19808
28027,Coahoma ,Mississippi,34.22918304,-90.60268275,11006,12796,23802
28029,Copiah ,Mississippi,31.86925182,-90.4487759,13704,15017,28721
28031,Covington ,Mississippi,31.6331971,-89.55263057,9252,9839,19091
28033,DeSoto ,Mississippi,34.87539586,-89.9918203,85174,90958,176132
28035,Forrest ,Mississippi,31.18889043,-89.25786593,35944,39573,75517
28037,Franklin ,Mississippi,31.47716458,-90.89790393,3706,4051,7757
28039,George ,Mississippi,30.86256298,-88.64397202,12008,11702,23710
28041,Greene ,Mississippi,31.21422826,-88.63917309,8294,5420,13714
28043,Grenada ,Mississippi,33.76985667,-89.80189907,10103,11175,21278
28045,Hancock ,Mississippi,30.41600618,-89.48851199,22779,23874,46653
28047,Harrison ,Mississippi,30.51184601,-89.11592523,99750,102876,202626
28049,Hinds ,Mississippi,32.26670043,-90.44284956,112877,128897,241774
28051,Holmes ,Mississippi,33.12353533,-90.09205496,8635,9440,18075
28053,Humphreys ,Mississippi,33.12865911,-90.52661097,3990,4549,8539
28055,Issaquena ,Mississippi,32.74140933,-90.98918635,807,521,1328
28057,Itawamba ,Mississippi,34.27998204,-88.36130636,11821,11659,23480
28059,Jackson ,Mississippi,30.54229725,-88.63570055,70065,71949,142014
28061,Jasper ,Mississippi,32.01912853,-89.11883672,8048,8481,16529
28063,Jefferson ,Mississippi,31.73427883,-91.03734354,3642,3704,7346
28065,Jefferson Davis ,Mississippi,31.56966594,-89.82299813,5543,5952,11495
28067,Jones ,Mississippi,31.62255149,-89.16881293,33352,35102,68454
28069,Kemper ,Mississippi,32.75457986,-88.64116921,5170,4937,10107
28071,Lafayette ,Mississippi,34.35674501,-89.48490772,25974,27485,53459
28073,Lamar ,Mississippi,31.20600688,-89.50866272,29243,31980,61223
28075,Lauderdale ,Mississippi,32.40426904,-88.66255119,37617,39706,77323
28077,Lawrence ,Mississippi,31.55017919,-90.10700088,6130,6500,12630
28079,Leake ,Mississippi,32.75351997,-89.52402352,11533,11337,22870
28081,Lee ,Mississippi,34.28990058,-88.68041851,40526,44389,84915
28083,Leflore ,Mississippi,33.55053813,-90.30108353,13916,15888,29804
28085,Lincoln ,Mississippi,31.53239244,-90.45400798,16255,18177,34432
28087,Lowndes ,Mississippi,33.47294137,-88.44331637,28365,31072,59437
28089,Madison ,Mississippi,32.63472693,-90.033696,49524,53974,103498
28091,Marion ,Mississippi,31.2308529,-89.82243548,12230,12972,25202
28093,Marshall ,Mississippi,34.7622819,-89.50306493,17736,18051,35787
28095,Monroe ,Mississippi,33.89226658,-88.48048216,17107,18733,35840
28097,Montgomery ,Mississippi,33.49398595,-89.61636879,4769,5429,10198
28099,Neshoba ,Mississippi,32.75348009,-89.11756548,13988,15388,29376
28101,Newton ,Mississippi,32.40023895,-89.11879432,10142,11382,21524
28103,Noxubee ,Mississippi,33.11015679,-88.56975391,5127,5701,10828
28105,Oktibbeha ,Mississippi,33.42495679,-88.87933353,24863,24618,49481
28107,Panola ,Mississippi,34.36390856,-89.95055954,16549,17694,34243
28109,Pearl River ,Mississippi,30.76883572,-89.58961899,27263,27886,55149
28111,Perry ,Mississippi,31.17202414,-88.99233716,5845,6183,12028
28113,Pike ,Mississippi,31.17484998,-90.40417607,18836,20901,39737
28115,Pontotoc ,Mississippi,34.22543951,-89.03739576,15304,16011,31315
28117,Prentiss ,Mississippi,34.61828123,-88.52007387,12304,13056,25360
28119,Quitman ,Mississippi,34.25139532,-90.28909958,3476,3896,7372
28121,Rankin ,Mississippi,32.26413027,-89.94579288,73041,78199,151240
28123,Scott ,Mississippi,32.40638545,-89.53763031,13870,14545,28415
28125,Sharkey ,Mississippi,32.8798711,-90.81315445,2147,2364,4511
28127,Simpson ,Mississippi,31.91315924,-89.91950001,13115,13958,27073
28129,Smith ,Mississippi,32.01768185,-89.50668014,7847,8216,16063
28131,Stone ,Mississippi,30.78996736,-89.11766734,9367,9008,18375
28133,Sunflower ,Mississippi,33.60227012,-90.58863552,13927,12605,26532
28135,Tallahatchie ,Mississippi,33.95047228,-90.17322935,8012,6349,14361
28137,Tate ,Mississippi,34.65032888,-89.94478702,13828,14665,28493
28139,Tippah ,Mississippi,34.76835416,-88.90889375,10673,11317,21990
28141,Tishomingo ,Mississippi,34.74039816,-88.239291,9491,9987,19478
28143,Tunica ,Mississippi,34.65197972,-90.3755026,4659,5511,10170
28145,Union ,Mississippi,34.49047737,-89.00386208,13942,14414,28356
28147,Walthall ,Mississippi,31.14842189,-90.10613781,7108,7493,14601
28149,Warren ,Mississippi,32.35726298,-90.85199213,22428,24647,47075
28151,Washington ,Mississippi,33.28378114,-90.94748707,22018,25068,47086
28153,Wayne ,Mississippi,31.64078874,-88.6958152,10072,10350,20422
28155,Webster ,Mississippi,33.61310083,-89.28480254,4788,5040,9828
28157,Wilkinson ,Mississippi,31.16107979,-91.31092617,4816,4174,8990
28159,Winston ,Mississippi,33.08850353,-89.03441456,8942,9416,18358
28161,Yalobusha ,Mississippi,34.02816003,-89.70768041,6085,6336,12421
28163,Yazoo ,Mississippi,32.78032626,-90.39642131,15543,12431,27974
29001,Adair ,Missouri,40.19057911,-92.60071921,12215,13110,25325
29003,Andrew ,Missouri,39.98353756,-94.80209503,8720,8683,17403
29005,Atchison ,Missouri,40.43081915,-95.42808898,2615,2655,5270
29007,Audrain ,Missouri,39.21573642,-91.84156315,11768,13967,25735
29009,Barry ,Missouri,36.70986228,-93.82905567,17823,17670,35493
29011,Barton ,Missouri,37.50232143,-94.34712534,5865,5985,11850
29013,Bates ,Missouri,38.25726018,-94.3400228,8014,8360,16374
29015,Benton ,Missouri,38.29484861,-93.28792737,9354,9635,18989
29017,Bollinger ,Missouri,37.3221838,-90.02592435,6140,6141,12281
29019,Boone ,Missouri,38.99061664,-92.30967501,85827,90688,176515
29021,Buchanan ,Missouri,39.65978627,-94.80588685,44691,44385,89076
29023,Butler ,Missouri,36.71641166,-90.40657485,20823,21910,42733
29025,Caldwell ,Missouri,39.65573553,-93.98269339,4585,4464,9049
29027,Callaway ,Missouri,38.83551113,-91.92603002,22874,21966,44840
29029,Camden ,Missouri,38.02702727,-92.7660399,22328,22768,45096
29031,Cape Girardeau ,Missouri,37.38402569,-89.68446694,37932,40392,78324
29033,Carroll ,Missouri,39.42698629,-93.50517645,4330,4513,8843
29035,Carter ,Missouri,36.94123568,-90.96234244,3010,3187,6197
29037,Cass ,Missouri,38.6469872,-94.35489154,50364,52314,102678
29039,Cedar ,Missouri,37.72385237,-93.85660176,6961,6977,13938
29041,Chariton ,Missouri,39.51509121,-92.96263864,3764,3782,7546
29043,Christian ,Missouri,36.96956914,-93.18885852,40995,43280,84275
29045,Clark ,Missouri,40.41033793,-91.73835443,3447,3353,6800
29047,Clay ,Missouri,39.31050762,-94.42088561,117296,121868,239164
29049,Clinton ,Missouri,39.60177278,-94.40458455,10266,10209,20475
29051,Cole ,Missouri,38.50540705,-92.28163958,38731,38009,76740
29053,Cooper ,Missouri,38.84354526,-92.81010853,9214,8408,17622
29055,Crawford ,Missouri,37.97635704,-91.30394012,11969,12311,24280
29057,Dade ,Missouri,37.43206461,-93.85026948,3884,3706,7590
29059,Dallas ,Missouri,37.68041979,-93.02367037,8212,8287,16499
29061,Daviess ,Missouri,39.96076035,-93.98549168,4187,4115,8302
29063,DeKalb ,Missouri,39.89315456,-94.40472385,7947,4617,12564
29065,Dent ,Missouri,37.60663057,-91.50791279,7692,7812,15504
29067,Douglas ,Missouri,36.93259192,-92.49878601,6700,6674,13374
29069,Dunklin ,Missouri,36.27211398,-90.09090926,14623,15805,30428
29071,Franklin ,Missouri,38.41112,-91.07503081,51339,51442,102781
29073,Gasconade ,Missouri,38.44087577,-91.50792245,7373,7373,14746
29075,Gentry ,Missouri,40.21204849,-94.40987215,3218,3447,6665
29077,Greene ,Missouri,37.25804812,-93.34199962,140366,148063,288429
29079,Grundy ,Missouri,40.11392197,-93.56535624,4906,5133,10039
29081,Harrison ,Missouri,40.35466918,-93.99204033,4263,4291,8554
29083,Henry ,Missouri,38.38517859,-93.79275178,10643,11122,21765
29085,Hickory ,Missouri,37.94079756,-93.32075053,4551,4817,9368
29087,Holt ,Missouri,40.09441845,-95.21555765,2197,2259,4456
29089,Howard ,Missouri,39.14250044,-92.69627275,5042,5071,10113
29091,Howell ,Missouri,36.77402351,-91.88652541,19640,20462,40102
29093,Iron ,Missouri,37.55515927,-90.77347762,5029,5192,10221
29095,Jackson ,Missouri,39.00847345,-94.34613475,334604,357399,692003
29097,Jasper ,Missouri,37.20355565,-94.34061072,58223,61015,119238
29099,Jefferson ,Missouri,38.2610598,-90.53773141,110887,112415,223302
29101,Johnson ,Missouri,38.74405969,-93.80641474,27715,25974,53689
29103,Knox ,Missouri,40.1282422,-92.14806316,1989,1962,3951
29105,Laclede ,Missouri,37.65831913,-92.59033978,17578,17929,35507
29107,Lafayette ,Missouri,39.0655542,-93.78550321,16106,16483,32589
29109,Lawrence ,Missouri,37.10638556,-93.83295889,18995,19138,38133
29111,Lewis ,Missouri,40.09687532,-91.72210604,5100,4927,10027
29113,Lincoln ,Missouri,39.05803523,-90.96006716,27526,28037,55563
29115,Linn ,Missouri,39.87020238,-93.10719868,5861,6325,12186
29117,Livingston ,Missouri,39.78211353,-93.54825545,6813,8263,15076
29119,McDonald ,Missouri,36.62868997,-94.34833815,11635,11192,22827
29121,Macon ,Missouri,39.83078275,-92.56461406,7683,7571,15254
29123,Madison ,Missouri,37.47804673,-90.34502139,6049,6156,12205
29125,Maries ,Missouri,38.16164637,-91.92485781,4449,4435,8884
29127,Marion ,Missouri,39.80594397,-91.62243355,13745,14927,28672
29129,Mercer ,Missouri,40.42233372,-93.56855068,1834,1830,3664
29131,Miller ,Missouri,38.21450555,-92.42838369,12314,12735,25049
29133,Mississippi ,Missouri,36.82808568,-89.2911453,7575,6173,13748
29135,Moniteau ,Missouri,38.63275723,-92.58309197,8413,7545,15958
29137,Monroe ,Missouri,39.49544997,-92.00073162,4402,4252,8654
29139,Montgomery ,Missouri,38.94145966,-91.47022827,5764,5781,11545
29141,Morgan ,Missouri,38.42371662,-92.88599261,9945,10192,20137
29143,New Madrid ,Missouri,36.59459088,-89.65174111,8558,9253,17811
29145,Newton ,Missouri,36.90550643,-94.33925588,28964,29238,58202
29147,Nodaway ,Missouri,40.36074621,-94.88344744,11225,11322,22547
29149,Oregon ,Missouri,36.68664391,-91.40334847,5376,5323,10699
29151,Osage ,Missouri,38.46038433,-91.86182632,7076,6543,13619
29153,Ozark ,Missouri,36.64931292,-92.44468628,4592,4644,9236
29155,Pemiscot ,Missouri,36.21138389,-89.78540088,8022,9009,17031
29157,Perry ,Missouri,37.70715831,-89.82444242,9457,9689,19146
29159,Pettis ,Missouri,38.72829157,-93.28509782,20918,21453,42371
29161,Phelps ,Missouri,37.87716673,-91.79233715,23541,21248,44789
29163,Pike ,Missouri,39.34383004,-91.17137211,10217,8272,18489
29165,Platte ,Missouri,39.38029248,-94.77381634,48720,50104,98824
29167,Polk ,Missouri,37.61649037,-93.40053128,15435,16114,31549
29169,Pulaski ,Missouri,37.82458078,-92.20763841,30025,22566,52591
29171,Putnam ,Missouri,40.47891271,-93.01616564,2389,2426,4815
29173,Ralls ,Missouri,39.52768457,-91.52203095,5178,5039,10217
29175,Randolph ,Missouri,39.44013585,-92.49707868,13102,11843,24945
29177,Ray ,Missouri,39.35238644,-93.98992328,11357,11468,22825
29179,Reynolds ,Missouri,37.36231937,-90.96908594,3238,3077,6315
29181,Ripley ,Missouri,36.65280539,-90.86382534,6817,6876,13693
29183,St. Charles ,Missouri,38.78192346,-90.67487533,191641,198344,389985
29185,St. Clair ,Missouri,38.03719356,-93.77596727,4663,4720,9383
29186,Ste. Genevieve ,Missouri,37.89440911,-90.19452365,8979,8892,17871
29187,St. Francois ,Missouri,37.81026606,-90.47227547,35900,30442,66342
29189,St. Louis ,Missouri,38.64053524,-90.44334714,473610,525074,998684
29195,Saline ,Missouri,39.1368469,-93.20184466,11559,11543,23102
29197,Schuyler ,Missouri,40.47025363,-92.52091987,2219,2283,4502
29199,Scotland ,Missouri,40.45259097,-92.14702659,2399,2499,4898
29201,Scott ,Missouri,37.05303994,-89.56851988,18712,20017,38729
29203,Shannon ,Missouri,37.15736115,-91.40046315,4012,4234,8246
29205,Shelby ,Missouri,39.797764,-92.07659853,3047,3014,6061
29207,Stoddard ,Missouri,36.85559875,-89.94430552,14365,15147,29512
29209,Stone ,Missouri,36.74692688,-93.45598936,15409,16118,31527
29211,Sullivan ,Missouri,40.21060077,-93.11149377,3052,3265,6317
29213,Taney ,Missouri,36.65476005,-93.04113449,26504,28216,54720
29215,Texas ,Missouri,37.31730082,-91.96504501,13397,12274,25671
29217,Vernon ,Missouri,37.8505824,-94.34243589,10088,10603,20691
29219,Warren ,Missouri,38.76460566,-91.16067059,16714,17194,33908
29221,Washington ,Missouri,37.96168855,-90.87741368,12835,12096,24931
29223,Wayne ,Missouri,37.11264651,-90.46140543,6544,6764,13308
29225,Webster ,Missouri,37.28089891,-92.87588215,19436,18646,38082
29227,Worth ,Missouri,40.47910197,-94.42212318,981,1059,2040
29229,Wright ,Missouri,37.27015252,-92.46872298,9029,9264,18293
29510,St. Louis city,Missouri,38.63582492,-90.24511587,150532,160741,311273
30001,Beaverhead ,Montana,45.13271279,-112.8988403,4748,4645,9393
30003,Big Horn ,Montana,45.42335612,-107.4898018,6572,6804,13376
30005,Blaine ,Montana,48.43267934,-108.9586205,3368,3359,6727
30007,Broadwater ,Montana,46.3324059,-111.495495,2975,2859,5834
30009,Carbon ,Montana,45.22738699,-109.0280601,5317,5229,10546
30011,Carter ,Montana,45.51679034,-104.5361595,649,669,1318
30013,Cascade ,Montana,47.30795554,-111.3470378,41269,40477,81746
30015,Chouteau ,Montana,47.88059235,-110.4352651,2839,2950,5789
30017,Custer ,Montana,46.25267128,-105.5717285,5955,5890,11845
30019,Daniels ,Montana,48.78378909,-105.5485417,884,869,1753
30021,Dawson ,Montana,47.26638273,-104.8994978,4877,4314,9191
30023,Deer Lodge ,Montana,46.06073087,-113.0679246,4835,4265,9100
30025,Fallon ,Montana,46.3340038,-104.4173829,1472,1366,2838
30027,Fergus ,Montana,47.263581,-109.2244601,5682,5591,11273
30029,Flathead ,Montana,48.2951464,-114.0496698,48823,49259,98082
30031,Gallatin ,Montana,45.54040564,-111.1703862,54246,50483,104729
30033,Garfield ,Montana,47.2776286,-106.9928979,605,536,1141
30035,Glacier ,Montana,48.705138,-112.9947363,6855,6844,13699
30037,Golden Valley ,Montana,46.38122292,-109.1751536,355,369,724
30039,Granite ,Montana,46.40448603,-113.4403622,1696,1573,3269
30041,Hill ,Montana,48.62822529,-110.1111867,8292,8147,16439
30043,Jefferson ,Montana,46.14845796,-112.0938045,5979,5799,11778
30045,Judith Basin ,Montana,47.04543213,-110.2660271,1058,893,1951
30047,Lake ,Montana,47.64590583,-114.0893417,14744,15030,29774
30049,Lewis and Clark ,Montana,47.12244511,-112.3904451,33186,33891,67077
30051,Liberty ,Montana,48.56171647,-111.0245712,1146,1134,2280
30053,Lincoln ,Montana,48.54244725,-115.4050724,9678,9680,19358
30055,McCone ,Montana,47.64521209,-105.7954254,828,802,1630
30057,Madison ,Montana,45.30069573,-111.9202762,4261,3957,8218
30059,Meagher ,Montana,46.59819977,-110.8856907,966,1002,1968
30061,Mineral ,Montana,47.14721011,-114.998283,2135,2076,4211
30063,Missoula ,Montana,47.03651207,-113.923704,58372,57611,115983
30065,Musselshell ,Montana,46.49658446,-108.3981048,2399,2408,4807
30067,Park ,Montana,45.48834444,-110.5266617,8164,8082,16246
30069,Petroleum ,Montana,47.11754267,-108.2501974,229,203,432
30071,Phillips ,Montana,48.25918629,-107.9132524,2101,2023,4124
30073,Pondera ,Montana,48.22776508,-112.2263469,3003,3041,6044
30075,Powder River ,Montana,45.39497963,-105.63019,820,799,1619
30077,Powell ,Montana,46.856351,-112.9361094,4310,2551,6861
30079,Prairie ,Montana,46.86050273,-105.3779575,673,669,1342
30081,Ravalli ,Montana,46.08169213,-114.1207457,20822,21080,41902
30083,Richland ,Montana,47.78788636,-104.5614135,5740,5620,11360
30085,Roosevelt ,Montana,48.29450728,-105.0164076,5559,5669,11228
30087,Rosebud ,Montana,46.22970147,-106.7307053,4608,4642,9250
30089,Sanders ,Montana,47.67477959,-115.1333008,5935,5586,11521
30091,Sheridan ,Montana,48.72123317,-104.5046732,1794,1780,3574
30093,Silver Bow ,Montana,45.90240169,-112.6567357,17588,17226,34814
30095,Stillwater ,Montana,45.669039,-109.3952157,4693,4717,9410
30097,Sweet Grass ,Montana,45.81388542,-109.9410379,1770,1883,3653
30099,Teton ,Montana,47.83711403,-112.24083,2994,3086,6080
30101,Toole ,Montana,48.65539831,-111.6956393,2824,2152,4976
30103,Treasure ,Montana,46.21145349,-107.2716308,384,393,777
30105,Valley ,Montana,48.36526507,-106.6674613,3730,3802,7532
30107,Wheatland ,Montana,46.46629869,-109.8445709,1079,1070,2149
30109,Wibaux ,Montana,46.96526307,-104.2489815,561,614,1175
30111,Yellowstone ,Montana,45.93734437,-108.2744158,77773,80043,157816
31001,Adams ,Nebraska,40.52447611,-98.50120921,15947,15636,31583
31003,Antelope ,Nebraska,42.17690728,-98.06668573,3204,3168,6372
31005,Arthur ,Nebraska,41.56894338,-101.6958058,205,213,418
31007,Banner ,Nebraska,41.54604323,-103.7105163,346,350,696
31009,Blaine ,Nebraska,41.91277949,-99.97682596,246,234,480
31011,Boone ,Nebraska,41.70678392,-98.06723996,2641,2672,5313
31013,Box Butte ,Nebraska,42.21977307,-103.0856583,5472,5617,11089
31015,Boyd ,Nebraska,42.89969629,-98.76654089,1028,1014,2042
31017,Brown ,Nebraska,42.42999822,-99.92950051,1430,1558,2988
31019,Buffalo ,Nebraska,40.85515479,-99.07497831,24593,24437,49030
31021,Burt ,Nebraska,41.85153151,-96.32861666,3209,3319,6528
31023,Butler ,Nebraska,41.22607638,-97.13175614,4056,4011,8067
31025,Cass ,Nebraska,40.90971149,-96.14087548,12929,12773,25702
31027,Cedar ,Nebraska,42.59925422,-97.25241821,4329,4194,8523
31029,Chase ,Nebraska,40.5241766,-101.6979837,1865,1869,3734
31031,Cherry ,Nebraska,42.54498673,-101.1185947,2847,2943,5790
31033,Cheyenne ,Nebraska,41.21976731,-102.9949571,4903,4949,9852
31035,Clay ,Nebraska,40.52443474,-98.05128639,3165,3067,6232
31037,Colfax ,Nebraska,41.57401085,-97.08646747,5870,4890,10760
31039,Cuming ,Nebraska,41.91639853,-96.78738588,4505,4486,8991
31041,Custer ,Nebraska,41.39427862,-99.72615089,5366,5464,10830
31043,Dakota ,Nebraska,42.39112903,-96.56456904,10219,10098,20317
31045,Dawes ,Nebraska,42.71971563,-103.1354341,4571,4325,8896
31047,Dawson ,Nebraska,40.86994882,-99.81957622,12241,11563,23804
31049,Deuel ,Nebraska,41.11155615,-102.3337843,892,1002,1894
31051,Dixon ,Nebraska,42.49321265,-96.86775695,2884,2862,5746
31053,Dodge ,Nebraska,41.57790456,-96.6540062,18126,18557,36683
31055,Douglas ,Nebraska,41.29534196,-96.15428469,273743,281249,554992
31057,Dundy ,Nebraska,40.17620052,-101.6879474,1013,1010,2023
31059,Fillmore ,Nebraska,40.52465689,-97.5964999,2782,2792,5574
31061,Franklin ,Nebraska,40.17632676,-98.95279856,1490,1516,3006
31063,Frontier ,Nebraska,40.53009375,-100.3941499,1326,1283,2609
31065,Furnas ,Nebraska,40.17644373,-99.9123095,2349,2437,4786
31067,Gage ,Nebraska,40.26188993,-96.68944161,10826,10769,21595
31069,Garden ,Nebraska,41.61940107,-102.3354584,937,923,1860
31071,Garfield ,Nebraska,41.91435621,-98.99140272,969,1006,1975
31073,Gosper ,Nebraska,40.51481874,-99.83070272,1000,1015,2015
31075,Grant ,Nebraska,41.9149707,-101.7405437,380,338,718
31077,Greeley ,Nebraska,41.56744423,-98.52121831,1207,1203,2410
31079,Hall ,Nebraska,40.87257784,-98.50216662,30830,30513,61343
31081,Hamilton ,Nebraska,40.87302317,-98.02286285,4564,4614,9178
31083,Harlan ,Nebraska,40.17649191,-99.40464602,1781,1657,3438
31085,Hayes ,Nebraska,40.52477449,-101.0618573,495,448,943
31087,Hitchcock ,Nebraska,40.1763376,-101.0422556,1414,1429,2843
31089,Holt ,Nebraska,42.45571153,-98.78383058,5142,5103,10245
31091,Hooker ,Nebraska,41.91606567,-101.1353202,324,367,691
31093,Howard ,Nebraska,41.22004846,-98.51710944,3227,3178,6405
31095,Jefferson ,Nebraska,40.17573211,-97.14272179,3486,3702,7188
31097,Johnson ,Nebraska,40.39263237,-96.26508491,3097,2100,5197
31099,Kearney ,Nebraska,40.50670322,-98.94801428,3240,3312,6552
31101,Keith ,Nebraska,41.19883824,-101.6612821,4141,3958,8099
31103,Keya Paha ,Nebraska,42.87887592,-99.71239992,416,376,792
31105,Kimball ,Nebraska,41.19776799,-103.7149173,1855,1812,3667
31107,Knox ,Nebraska,42.63681867,-97.89190471,4150,4310,8460
31109,Lancaster ,Nebraska,40.78417182,-96.6877531,155699,154395,310094
31111,Lincoln ,Nebraska,41.04774161,-100.7452961,17497,17936,35433
31113,Logan ,Nebraska,41.5665035,-100.4828432,462,424,886
31115,Loup ,Nebraska,41.91385121,-99.45438349,291,294,585
31117,McPherson ,Nebraska,41.56816502,-101.060504,241,213,454
31119,Madison ,Nebraska,41.91669511,-97.60076428,17490,17674,35164
31121,Merrick ,Nebraska,41.16903981,-98.03801992,3919,3884,7803
31123,Morrill ,Nebraska,41.71601484,-103.0106143,2445,2396,4841
31125,Nance ,Nebraska,41.39732361,-97.99220457,1769,1785,3554
31127,Nemaha ,Nebraska,40.38765066,-95.84983385,3465,3539,7004
31129,Nuckolls ,Nebraska,40.17638924,-98.04718735,2140,2135,4275
31131,Otoe ,Nebraska,40.64850041,-96.13476498,7742,8154,15896
31133,Pawnee ,Nebraska,40.13146339,-96.23706168,1277,1399,2676
31135,Perkins ,Nebraska,40.85096591,-101.6497964,1499,1408,2907
31137,Phelps ,Nebraska,40.51110579,-99.41454784,4578,4542,9120
31139,Pierce ,Nebraska,42.2643608,-97.60130057,3566,3591,7157
31141,Platte ,Nebraska,41.57129635,-97.52113913,16860,16203,33063
31143,Polk ,Nebraska,41.18690328,-97.56843548,2540,2715,5255
31145,Red Willow ,Nebraska,40.17582818,-100.4768771,5401,5405,10806
31147,Richardson ,Nebraska,40.12504357,-95.71754775,3974,4035,8009
31149,Rock ,Nebraska,42.42131375,-99.44991303,674,676,1350
31151,Saline ,Nebraska,40.52406581,-97.14092156,7257,7031,14288
31153,Sarpy ,Nebraska,41.11290795,-96.11195395,89176,89175,178351
31155,Saunders ,Nebraska,41.2263652,-96.63737949,10628,10396,21024
31157,Scotts Bluff ,Nebraska,41.8505872,-103.7079902,17575,18680,36255
31159,Seward ,Nebraska,40.87237945,-97.1395198,8726,8401,17127
31161,Sheridan ,Nebraska,42.50475031,-102.4089194,2566,2668,5234
31163,Sherman ,Nebraska,41.22058938,-98.97620432,1527,1515,3042
31165,Sioux ,Nebraska,42.48765466,-103.7588782,643,623,1266
31167,Stanton ,Nebraska,41.91693531,-97.19391196,3002,2990,5992
31169,Thayer ,Nebraska,40.17623966,-97.59495023,2545,2553,5098
31171,Thomas ,Nebraska,41.91358527,-100.555794,321,324,645
31173,Thurston ,Nebraska,42.15819829,-96.54402727,3545,3595,7140
31175,Valley ,Nebraska,41.56732076,-98.9818789,2073,2151,4224
31177,Washington ,Nebraska,41.53106395,-96.22200507,9911,10308,20219
31179,Wayne ,Nebraska,42.20928624,-97.11926279,4716,4651,9367
31181,Webster ,Nebraska,40.17644085,-98.49996271,1769,1802,3571
31183,Wheeler ,Nebraska,41.91476707,-98.52818128,435,387,822
31185,York ,Nebraska,40.87274208,-97.59711776,6693,7106,13799
32001,Churchill ,Nevada,39.58089267,-118.3358177,12138,11872,24010
32003,Clark ,Nevada,36.21523782,-115.013537,1069779,1071795,2141574
32005,Douglas ,Nevada,38.91219011,-119.6163894,24102,23726,47828
32007,Elko ,Nevada,41.14581554,-115.3577645,27199,25053,52252
32009,Esmeralda ,Nevada,37.78465844,-117.6323112,406,575,981
32011,Eureka ,Nevada,39.98386155,-116.2685845,921,909,1830
32013,Humboldt ,Nevada,41.40684198,-118.1119988,8779,8125,16904
32015,Lander ,Nevada,39.93366329,-117.0380259,3347,2399,5746
32017,Lincoln ,Nevada,37.64332831,-114.8775403,2673,2501,5174
32019,Lyon ,Nevada,39.02028336,-119.1891216,26757,26398,53155
32021,Mineral ,Nevada,38.53876198,-118.4350801,2205,2243,4448
32023,Nye ,Nevada,38.04224741,-116.4719135,22243,21462,43705
32027,Pershing ,Nevada,40.44040934,-118.4044135,4286,2325,6611
32029,Storey ,Nevada,39.44693227,-119.52935,1963,1978,3941
32031,Washoe ,Nevada,40.66566754,-119.6642682,226751,223735,450486
32033,White Pine ,Nevada,39.44210431,-114.9015451,5704,4033,9737
32510,Carson City,Nevada,39.1511475,-119.747419,27912,26555,54467
33001,Belknap ,New Hampshire,43.51790463,-71.42266291,29736,30904,60640
33003,Carroll ,New Hampshire,43.87381081,-71.20309837,23845,23995,47840
33005,Cheshire ,New Hampshire,42.91937813,-72.25118843,37221,39042,76263
33007,Coos ,New Hampshire,44.68957026,-71.3056348,16874,15164,32038
33009,Grafton ,New Hampshire,43.94066039,-71.8207476,44161,45650,89811
33011,Hillsborough ,New Hampshire,42.91533316,-71.71608466,204293,206794,411087
33013,Merrimack ,New Hampshire,43.29746512,-71.68023962,73538,75914,149452
33015,Rockingham ,New Hampshire,42.9875554,-71.12536673,151201,153928,305129
33017,Strafford ,New Hampshire,43.296957,-71.028868,62703,65534,128237
33019,Sullivan ,New Hampshire,43.36142641,-72.22217146,21411,21714,43125
34001,Atlantic ,New Jersey,39.47773846,-74.66097651,130026,138513,268539
34003,Bergen ,New Jersey,40.95962242,-74.07423081,450784,479215,929999
34005,Burlington ,New Jersey,39.87772221,-74.66806254,219534,226833,446367
34007,Camden ,New Jersey,39.8035099,-74.95972886,245068,262299,507367
34009,Cape May ,New Jersey,39.14899693,-74.8002006,45829,47876,93705
34011,Cumberland ,New Jersey,39.37383947,-75.11075139,78687,74713,153400
34013,Essex ,New Jersey,40.78722696,-74.24704975,381576,411979,793555
34015,Gloucester ,New Jersey,39.71727924,-75.14141018,141229,149623,290852
34017,Hudson ,New Jersey,40.73510236,-74.07770569,332268,336363,668631
34019,Hunterdon ,New Jersey,40.56730053,-74.91223438,62447,62604,125051
34021,Mercer ,New Jersey,40.28343356,-74.70176113,180369,188393,368762
34023,Middlesex ,New Jersey,40.43915317,-74.41170264,407247,419451,826698
34025,Monmouth ,New Jersey,40.26048276,-74.22097069,303154,320233,623387
34027,Morris ,New Jersey,40.8619971,-74.54452423,242484,251899,494383
34029,Ocean ,New Jersey,39.88512428,-74.28090728,285371,306568,591939
34031,Passaic ,New Jersey,41.03444981,-74.30083491,245463,258578,504041
34033,Salem ,New Jersey,39.5876128,-75.34904978,30982,32354,63336
34035,Somerset ,New Jersey,40.56350043,-74.61634548,161296,168880,330176
34037,Sussex ,New Jersey,41.13925063,-74.69089802,70730,71568,142298
34039,Union ,New Jersey,40.66001624,-74.308505,269450,283616,553066
34041,Warren ,New Jersey,40.85716228,-74.99732739,51936,54357,106293
35001,Bernalillo ,New Mexico,35.05134127,-106.6701646,332271,345421,677692
35003,Catron ,New Mexico,33.91527613,-108.404611,1930,1609,3539
35005,Chaves ,New Mexico,33.36327779,-104.4669079,32600,32859,65459
35006,Cibola ,New Mexico,34.91252822,-107.999704,13648,13330,26978
35007,Colfax ,New Mexico,36.60613869,-104.6468402,6309,6044,12353
35009,Curry ,New Mexico,34.57423182,-103.3469955,26109,24090,50199
35011,De Baca ,New Mexico,34.34245187,-104.4120233,1052,1008,2060
35013,Do�a Ana ,New Mexico,32.35264734,-106.8327815,105774,109564,215338
35015,Eddy ,New Mexico,32.47148539,-104.3043076,28989,28448,57437
35017,Grant ,New Mexico,32.73887361,-108.3824025,13869,14192,28061
35019,Guadalupe ,New Mexico,34.86330572,-104.7906564,2507,1875,4382
35021,Harding ,New Mexico,35.85791979,-103.8202698,266,193,459
35023,Hidalgo ,New Mexico,31.91403805,-108.7147774,2149,2222,4371
35025,Lea ,New Mexico,32.79210292,-103.4124726,36137,33989,70126
35027,Lincoln ,New Mexico,33.74529939,-105.4592928,9228,10254,19482
35028,Los Alamos ,New Mexico,35.86936543,-106.3073688,9353,9003,18356
35029,Luna ,New Mexico,32.18222646,-107.7498081,12020,12244,24264
35031,McKinley ,New Mexico,35.5806651,-108.2617944,35158,37691,72849
35033,Mora ,New Mexico,36.01039817,-104.9448169,2230,2333,4563
35035,Otero ,New Mexico,32.61319477,-105.7414623,33886,31859,65745
35037,Quay ,New Mexico,35.10430373,-103.5497569,3881,4492,8373
35039,Rio Arriba ,New Mexico,36.50957666,-106.6931428,19250,20057,39307
35041,Roosevelt ,New Mexico,34.02116947,-103.4800491,9523,9594,19117
35043,Sandoval ,New Mexico,35.68857595,-106.8659412,68955,71814,140769
35045,San Juan ,New Mexico,36.50852407,-108.3206218,63123,64332,127455
35047,San Miguel ,New Mexico,35.48044092,-104.8158346,14108,13926,28034
35049,Santa Fe ,New Mexico,35.50691318,-105.9762643,72344,76573,148917
35051,Sierra ,New Mexico,33.13049587,-107.192407,5516,5619,11135
35053,Socorro ,New Mexico,34.00716999,-106.9302467,8799,8201,17000
35055,Taos ,New Mexico,36.57830164,-105.6309615,16076,16812,32888
35057,Torrance ,New Mexico,34.64046508,-105.8508184,8358,7237,15595
35059,Union ,New Mexico,36.48160047,-103.4709993,2302,1873,4175
35061,Valencia ,New Mexico,34.71545948,-106.8090338,38130,37826,75956
36001,Albany ,New York,42.60017675,-73.97355542,148910,158516,307426
36003,Allegany ,New York,42.25740172,-78.02758162,23755,23270,47025
36005,Bronx ,New York,40.85002316,-73.86598287,676963,760909,1437872
36007,Broome ,New York,42.16024937,-75.81961998,95608,98794,194402
36009,Cattaraugus ,New York,42.24860036,-78.67884765,38491,39195,77686
36011,Cayuga ,New York,42.917498,-76.55450639,39982,37886,77868
36013,Chautauqua ,New York,42.2281649,-79.36634265,63960,65696,129656
36015,Chemung ,New York,42.14126252,-76.76003959,42556,43184,85740
36017,Chenango ,New York,42.49350478,-75.61159164,24227,24121,48348
36019,Clinton ,New York,44.74618213,-73.67816578,41499,39295,80794
36021,Columbia ,New York,42.25008106,-73.63179678,30495,30424,60919
36023,Cortland ,New York,42.59501366,-76.0702786,23550,24573,48123
36025,Delaware ,New York,42.19806703,-74.9664674,22943,22559,45502
36027,Dutchess ,New York,41.76514669,-73.74286,146174,147720,293894
36029,Erie ,New York,42.76395139,-78.73231719,444998,474868,919866
36031,Essex ,New York,44.11719121,-73.77260404,19622,18129,37751
36033,Franklin ,New York,44.5928607,-74.30383467,27816,22876,50692
36035,Fulton ,New York,43.11383487,-74.42216178,26847,26896,53743
36037,Genesee ,New York,43.00093172,-78.19375274,29022,29090,58112
36039,Greene ,New York,42.27651367,-74.12272098,24903,22714,47617
36041,Hamilton ,New York,43.661128,-74.49737532,2347,2228,4575
36043,Herkimer ,New York,43.4197052,-74.96252554,30918,31587,62505
36045,Jefferson ,New York,44.04944181,-75.92097941,59931,54517,114448
36047,Kings ,New York,40.63954067,-73.9385268,1231912,1368835,2600747
36049,Lewis ,New York,43.78465719,-75.44884855,13451,13268,26719
36051,Livingston ,New York,42.72806294,-77.77549402,32050,31857,63907
36053,Madison ,New York,42.91276591,-75.66964863,35252,36107,71359
36055,Monroe ,New York,43.14644638,-77.69608947,359374,384874,744248
36057,Montgomery ,New York,42.90229181,-74.4397157,24265,25161,49426
36059,Nassau ,New York,40.73280316,-73.586404,659405,697159,1356564
36061,New York ,New York,40.77817623,-73.967492,772144,860336,1632480
36063,Niagara ,New York,43.20006123,-78.74524869,103127,108577,211704
36065,Oneida ,New York,43.24173586,-75.43585109,115089,115693,230782
36067,Onondaga ,New York,43.00581356,-76.19463475,223995,240247,464242
36069,Ontario ,New York,42.85284829,-77.29982004,53704,55768,109472
36071,Orange ,New York,41.4021367,-74.3055448,189484,188743,378227
36073,Orleans ,New York,43.25207731,-78.23121307,20539,20636,41175
36075,Oswego ,New York,43.42692163,-76.14136172,59648,59456,119104
36077,Otsego ,New York,42.63374626,-75.03259883,29127,31117,60244
36079,Putnam ,New York,41.42666294,-73.74947837,49296,49774,99070
36081,Queens ,New York,40.70228386,-73.82027034,1114654,1183859,2298513
36083,Rensselaer ,New York,42.71107853,-73.5097181,78611,80820,159431
36085,Richmond ,New York,40.58077351,-74.15238558,229424,244677,474101
36087,Rockland ,New York,41.15237652,-74.02406184,158667,165019,323686
36089,St. Lawrence ,New York,44.49639515,-75.06908179,55780,53778,109558
36091,Saratoga ,New York,43.10737962,-73.86389772,112468,114909,227377
36093,Schenectady ,New York,42.81812731,-74.05857152,75453,79430,154883
36095,Schoharie ,New York,42.58821666,-74.44211424,15620,15744,31364
36097,Schuyler ,New York,42.39380391,-76.87517163,8979,9013,17992
36099,Seneca ,New York,42.78105353,-76.82378259,18096,16516,34612
36101,Steuben ,New York,42.26780886,-77.38379324,48397,48530,96927
36103,Suffolk ,New York,40.86860996,-72.84481197,732269,755632,1487901
36105,Sullivan ,New York,41.71643581,-74.76811363,38595,36616,75211
36107,Tioga ,New York,42.17033555,-76.30634885,24264,24781,49045
36109,Tompkins ,New York,42.45202686,-76.47363748,50823,52139,102962
36111,Ulster ,New York,41.88813881,-74.2585444,88774,90529,179303
36113,Warren ,New York,43.56096669,-73.84601676,31698,32782,64480
36115,Washington ,New York,43.31371305,-73.43075214,32002,29826,61828
36117,Wayne ,New York,43.15663708,-77.02937262,44971,45885,90856
36119,Westchester ,New York,41.16231784,-73.75606058,468898,499917,968815
36121,Wyoming ,New York,42.70236927,-78.22445827,21734,18831,40565
36123,Yates ,New York,42.63344943,-77.10546795,11999,13010,25009
37001,Alamance ,North Carolina,36.04373147,-79.39944023,76259,84317,160576
37003,Alexander ,North Carolina,35.92102819,-81.17701967,18942,18177,37119
37005,Alleghany ,North Carolina,36.49129365,-81.1279093,5386,5587,10973
37007,Anson ,North Carolina,34.97381294,-80.1026918,13285,12021,25306
37009,Ashe ,North Carolina,36.43447673,-81.50050207,13168,13618,26786
37011,Avery ,North Carolina,36.07654209,-81.92258339,9488,8013,17501
37013,Beaufort ,North Carolina,35.49400182,-76.85978139,22709,24534,47243
37015,Bertie ,North Carolina,36.06616727,-76.97866801,9895,9749,19644
37017,Bladen ,North Carolina,34.61458694,-78.56363615,16054,17724,33778
37019,Brunswick ,North Carolina,34.0709855,-78.23769498,61281,65579,126860
37021,Buncombe ,North Carolina,35.61118329,-82.53011353,122297,132177,254474
37023,Burke ,North Carolina,35.74961162,-81.70477517,44798,44914,89712
37025,Cabarrus ,North Carolina,35.38678659,-80.55186546,98094,103354,201448
37027,Caldwell ,North Carolina,35.95302854,-81.54640572,40354,41425,81779
37029,Camden ,North Carolina,36.38770417,-76.20636217,5263,5184,10447
37031,Carteret ,North Carolina,34.83573,-76.65889147,33839,35081,68920
37033,Caswell ,North Carolina,36.39317244,-79.33353355,11393,11353,22746
37035,Catawba ,North Carolina,35.66204223,-81.21507007,76703,80026,156729
37037,Chatham ,North Carolina,35.70257379,-79.25528761,33477,36314,69791
37039,Cherokee ,North Carolina,35.133873,-84.06347829,13583,14085,27668
37041,Chowan ,North Carolina,36.15083675,-76.60789636,6653,7552,14205
37043,Clay ,North Carolina,35.05721769,-83.75017335,5125,5688,10813
37045,Cleveland ,North Carolina,35.3340848,-81.55554657,46856,50303,97159
37047,Columbus ,North Carolina,34.26564889,-78.6550215,27981,28312,56293
37049,Craven ,North Carolina,35.12485682,-77.09389405,52246,50836,103082
37051,Cumberland ,North Carolina,35.04861925,-78.82755663,165152,166954,332106
37053,Currituck ,North Carolina,36.40307992,-76.00594024,12822,12974,25796
37055,Dare ,North Carolina,35.77953729,-75.79799395,17614,18127,35741
37057,Davidson ,North Carolina,35.79335504,-80.21274505,80508,84156,164664
37059,Davie ,North Carolina,35.92911133,-80.5444734,20374,21617,41991
37061,Duplin ,North Carolina,34.93653802,-77.93300726,28780,30282,59062
37063,Durham ,North Carolina,36.03601682,-78.87662143,146535,159922,306457
37065,Edgecombe ,North Carolina,35.91288115,-77.59706062,24856,28476,53332
37067,Forsyth ,North Carolina,36.13062135,-80.25629772,176337,195236,371573
37069,Franklin ,North Carolina,36.08275502,-78.28570288,32281,32621,64902
37071,Gaston ,North Carolina,35.29435359,-81.18028429,104371,112214,216585
37073,Gates ,North Carolina,36.44490682,-76.7004673,5627,5936,11563
37075,Graham ,North Carolina,35.35016747,-83.83348116,4210,4347,8557
37077,Granville ,North Carolina,36.30404949,-78.6527227,30046,28828,58874
37079,Greene ,North Carolina,35.48500257,-77.67576148,11593,9415,21008
37081,Guilford ,North Carolina,36.07946835,-79.78890758,248019,275563,523582
37083,Halifax ,North Carolina,36.25744662,-77.65173466,24959,26778,51737
37085,Harnett ,North Carolina,35.36863299,-78.86941474,64574,65787,130361
37087,Haywood ,North Carolina,35.5560423,-82.98219391,29220,31213,60433
37089,Henderson ,North Carolina,35.33631095,-82.47996964,54724,58901,113625
37091,Hertford ,North Carolina,36.35906559,-76.98200271,11947,12206,24153
37093,Hoke ,North Carolina,35.01754332,-79.23726353,26320,26919,53239
37095,Hyde ,North Carolina,35.53048716,-76.25080937,2832,2561,5393
37097,Iredell ,North Carolina,35.80702693,-80.87344028,84936,87589,172525
37099,Jackson ,North Carolina,35.28753605,-83.14082688,20838,21418,42256
37101,Johnston ,North Carolina,35.51781457,-78.36571446,93865,97307,191172
37103,Jones ,North Carolina,35.02172493,-77.35518726,4828,4867,9695
37105,Lee ,North Carolina,35.47518972,-79.17147917,29225,30900,60125
37107,Lenoir ,North Carolina,35.23877341,-77.641246,27391,29836,57227
37109,Lincoln ,North Carolina,35.48558087,-81.22350913,40372,41069,81441
37111,McDowell ,North Carolina,35.68169981,-82.04932313,22833,22276,45109
37113,Macon ,North Carolina,35.15047456,-83.42212187,16630,17780,34410
37115,Madison ,North Carolina,35.85801433,-82.70576464,10502,10903,21405
37117,Martin ,North Carolina,35.84321272,-77.10924769,10805,12249,23054
37119,Mecklenburg ,North Carolina,35.24671331,-80.83277923,506721,547593,1054314
37121,Mitchell ,North Carolina,36.01329687,-82.16363888,7400,7640,15040
37123,Montgomery ,North Carolina,35.33246513,-79.90548647,13546,13792,27338
37125,Moore ,North Carolina,35.31064403,-79.48138044,46002,49627,95629
37127,Nash ,North Carolina,35.96725095,-77.98643326,45125,48878,94003
37129,New Hanover ,North Carolina,34.23277288,-77.88471177,107274,116957,224231
37131,Northampton ,North Carolina,36.41776207,-77.39685937,9845,10341,20186
37133,Onslow ,North Carolina,34.7321275,-77.43208152,107681,86231,193912
37135,Orange ,North Carolina,36.06110475,-79.12065992,68187,74751,142938
37137,Pamlico ,North Carolina,35.14345019,-76.74069804,6563,6179,12742
37139,Pasquotank ,North Carolina,36.29547667,-76.28398919,19146,20333,39479
37141,Pender ,North Carolina,34.52481543,-77.90509381,29239,29781,59020
37143,Perquimans ,North Carolina,36.20584816,-76.44114256,6493,6966,13459
37145,Person ,North Carolina,36.39000491,-78.97178239,18989,20316,39305
37147,Pitt ,North Carolina,35.59329582,-77.37449546,83620,93752,177372
37149,Polk ,North Carolina,35.27927468,-82.16966168,9682,10776,20458
37151,Randolph ,North Carolina,35.71034005,-79.80600737,70428,72530,142958
37153,Richmond ,North Carolina,35.00593922,-79.74784832,22124,23065,45189
37155,Robeson ,North Carolina,34.64021397,-79.10392205,64365,69077,133442
37157,Rockingham ,North Carolina,36.39601372,-79.77499284,43989,47281,91270
37159,Rowan ,North Carolina,35.63947931,-80.5247895,69165,70440,139605
37161,Rutherford ,North Carolina,35.40256509,-81.91984347,32258,34274,66532
37163,Sampson ,North Carolina,34.99154034,-78.37138579,31231,32330,63561
37165,Scotland ,North Carolina,34.84089929,-79.48037764,17398,17864,35262
37167,Stanly ,North Carolina,35.31198126,-80.25098429,30445,30669,61114
37169,Stokes ,North Carolina,36.4018924,-80.23949993,22483,23422,45905
37171,Surry ,North Carolina,36.41477281,-80.68812365,34858,37241,72099
37173,Swain ,North Carolina,35.48675461,-83.49278243,6799,7455,14254
37175,Transylvania ,North Carolina,35.20214088,-82.7982083,16045,17468,33513
37177,Tyrrell ,North Carolina,35.81720598,-76.20895098,2365,1754,4119
37179,Union ,North Carolina,34.98840747,-80.53072,111658,115036,226694
37181,Vance ,North Carolina,36.36489877,-78.40792609,20823,23659,44482
37183,Wake ,North Carolina,35.79025688,-78.65031091,508866,537692,1046558
37185,Warren ,North Carolina,36.39652058,-78.10668108,9985,10048,20033
37187,Washington ,North Carolina,35.82258904,-76.57747822,5726,6430,12156
37189,Watauga ,North Carolina,36.23109566,-81.69643781,27145,26972,54117
37191,Wayne ,North Carolina,35.3639644,-78.00399647,60640,63362,124002
37193,Wilkes ,North Carolina,36.20627886,-81.16339436,33719,34741,68460
37195,Wilson ,North Carolina,35.7051462,-77.91866574,38362,42974,81336
37197,Yadkin ,North Carolina,36.16053316,-80.66523626,18666,18999,37665
37199,Yancey ,North Carolina,35.89894457,-82.30762486,8648,9019,17667
38001,Adams ,North Dakota,46.09683245,-102.5285067,1115,1236,2351
38003,Barnes ,North Dakota,46.93610904,-98.07156824,5430,5406,10836
38005,Benson ,North Dakota,48.06938279,-99.36601031,3529,3357,6886
38007,Billings ,North Dakota,47.02341651,-103.3763696,556,390,946
38009,Bottineau ,North Dakota,48.79217884,-100.8333194,3457,3132,6589
38011,Bowman ,North Dakota,46.11262384,-103.5207001,1590,1605,3195
38013,Burke ,North Dakota,48.79099687,-102.5182976,1183,1030,2213
38015,Burleigh ,North Dakota,46.97737997,-100.4687377,47152,46585,93737
38017,Cass ,North Dakota,46.93297472,-97.24804702,88346,85856,174202
38019,Cavalier ,North Dakota,48.77234191,-98.46485741,1959,1865,3824
38021,Dickey ,North Dakota,46.11017838,-98.50466814,2450,2520,4970
38023,Divide ,North Dakota,48.81491654,-103.4872455,1174,1195,2369
38025,Dunn ,North Dakota,47.35676924,-102.6182671,2298,2089,4387
38027,Eddy ,North Dakota,47.71758594,-98.90162502,1085,1228,2313
38029,Emmons ,North Dakota,46.28504329,-100.2387717,1704,1648,3352
38031,Foster ,North Dakota,47.45706425,-98.88298096,1616,1674,3290
38033,Golden Valley ,North Dakota,46.94029689,-103.8466232,892,990,1882
38035,Grand Forks ,North Dakota,47.92191055,-97.45697388,36536,33864,70400
38037,Grant ,North Dakota,46.35828749,-101.6397138,1205,1175,2380
38039,Griggs ,North Dakota,47.45728109,-98.23704598,1142,1124,2266
38041,Hettinger ,North Dakota,46.4325241,-102.4603531,1250,1326,2576
38043,Kidder ,North Dakota,46.9801473,-99.78009296,1301,1159,2460
38045,LaMoure ,North Dakota,46.45690053,-98.5354267,2148,1952,4100
38047,Logan ,North Dakota,46.45735484,-99.47742305,1000,927,1927
38049,McHenry ,North Dakota,48.23456893,-100.6362796,3034,2893,5927
38051,McIntosh ,North Dakota,46.11184383,-99.44119708,1323,1331,2654
38053,McKenzie ,North Dakota,47.74018778,-103.3952901,6822,5714,12536
38055,McLean ,North Dakota,47.60696208,-101.3218558,4958,4650,9608
38057,Mercer ,North Dakota,47.30921183,-101.8315314,4406,4164,8570
38059,Morton ,North Dakota,46.71606249,-101.2811632,15753,14791,30544
38061,Mountrail ,North Dakota,48.20132746,-102.3556636,5489,4663,10152
38063,Nelson ,North Dakota,47.92170063,-98.19205659,1485,1435,2920
38065,Oliver ,North Dakota,47.11528607,-101.3403811,935,902,1837
38067,Pembina ,North Dakota,48.76749985,-97.55184789,3649,3367,7016
38069,Pierce ,North Dakota,48.24959345,-99.9718346,2115,2095,4210
38071,Ramsey ,North Dakota,48.26893644,-98.72012085,5886,5671,11557
38073,Ransom ,North Dakota,46.45616097,-97.6574645,2677,2684,5361
38075,Renville ,North Dakota,48.71906618,-101.6578056,1258,1237,2495
38077,Richland ,North Dakota,46.26460622,-96.94829461,8528,7760,16288
38079,Rolette ,North Dakota,48.77245429,-99.84096633,7218,7385,14603
38081,Sargent ,North Dakota,46.10782593,-97.63055638,2052,1831,3883
38083,Sheridan ,North Dakota,47.5754104,-100.345679,723,682,1405
38085,Sioux ,North Dakota,46.11266484,-101.0404158,2209,2204,4413
38087,Slope ,North Dakota,46.44722142,-103.459864,353,351,704
38089,Stark ,North Dakota,46.81068349,-102.6551191,15864,15012,30876
38091,Steele ,North Dakota,47.45616684,-97.72469898,1001,909,1910
38093,Stutsman ,North Dakota,46.97923427,-98.95883535,10875,10189,21064
38095,Towner ,North Dakota,48.68553991,-99.24577986,1197,1049,2246
38097,Traill ,North Dakota,47.45418015,-97.16161113,4077,3942,8019
38099,Walsh ,North Dakota,48.36946565,-97.72134499,5543,5259,10802
38101,Ward ,North Dakota,48.22174536,-101.5418101,35881,33153,69034
38103,Wells ,North Dakota,47.58752304,-99.66097447,2003,2052,4055
38105,Williams ,North Dakota,48.34368819,-103.4802303,18751,15310,34061
39001,Adams ,Ohio,38.84561727,-83.47203222,13950,13928,27878
39003,Allen ,Ohio,40.7715393,-84.10579195,52371,51271,103642
39005,Ashland ,Ohio,40.84601738,-82.27068713,26101,27376,53477
39007,Ashtabula ,Ohio,41.70754845,-80.74829077,49335,48801,98136
39009,Athens ,Ohio,39.33388903,-82.045206,32846,33090,65936
39011,Auglaize ,Ohio,40.5609187,-84.22172796,22705,23079,45784
39013,Belmont ,Ohio,40.01583732,-80.98846129,34995,33477,68472
39015,Brown ,Ohio,38.93403314,-83.86743753,21649,22030,43679
39017,Butler ,Ohio,39.43862635,-84.57557158,185536,192758,378294
39019,Carroll ,Ohio,40.57957743,-81.08971649,13752,13826,27578
39021,Champaign ,Ohio,40.13770896,-83.76952765,19366,19498,38864
39023,Clark ,Ohio,39.91680908,-83.78386035,65405,69793,135198
39025,Clermont ,Ohio,39.04746294,-84.15184923,100124,103092,203216
39027,Clinton ,Ohio,39.41498114,-83.80836744,20769,21127,41896
39029,Columbiana ,Ohio,40.76842514,-80.77719636,52418,51585,104003
39031,Coshocton ,Ohio,40.30166494,-81.92001827,18108,18466,36574
39033,Crawford ,Ohio,40.85077394,-82.91978045,20612,21409,42021
39035,Cuyahoga ,Ohio,41.42447412,-81.65864095,597647,656136,1253783
39037,Darke ,Ohio,40.13326865,-84.61940476,25557,26177,51734
39039,Defiance ,Ohio,41.32391642,-84.49047494,19019,19260,38279
39041,Delaware ,Ohio,40.27839735,-83.00487427,97504,99504,197008
39043,Erie ,Ohio,41.36324786,-82.61923756,36863,38273,75136
39045,Fairfield ,Ohio,39.75163239,-82.63057755,76254,76656,152910
39047,Fayette ,Ohio,39.55987568,-83.4560873,13960,14685,28645
39049,Franklin ,Ohio,39.96954221,-83.00929575,622353,652980,1275333
39051,Fulton ,Ohio,41.60181773,-84.13008802,20940,21365,42305
39053,Gallia ,Ohio,38.82470019,-82.31690825,14802,15393,30195
39055,Geauga ,Ohio,41.49955301,-81.17863662,46425,47536,93961
39057,Greene ,Ohio,39.69146532,-83.88989053,81592,84219,165811
39059,Guernsey ,Ohio,40.05203339,-81.49425794,19522,19752,39274
39061,Hamilton ,Ohio,39.19554057,-84.54277113,391728,420309,812037
39063,Hancock ,Ohio,41.00192055,-83.66654032,37306,38384,75690
39065,Hardin ,Ohio,40.66151713,-83.65942524,15639,15903,31542
39067,Harrison ,Ohio,40.29383146,-81.09111612,7566,7741,15307
39069,Henry ,Ohio,41.33387813,-84.06823017,13440,13876,27316
39071,Highland ,Ohio,39.18471681,-83.60098263,21136,21871,43007
39073,Hocking ,Ohio,39.49705464,-82.47925427,14129,14366,28495
39075,Holmes ,Ohio,40.56120787,-81.92934087,21874,21985,43859
39077,Huron ,Ohio,41.14615232,-82.59840615,28770,29687,58457
39079,Jackson ,Ohio,39.01964968,-82.61838165,15885,16639,32524
39081,Jefferson ,Ohio,40.38501036,-80.76099604,32489,34397,66886
39083,Knox ,Ohio,40.39875979,-82.42151397,29959,31256,61215
39085,Lake ,Ohio,41.69656007,-81.23734278,112379,117673,230052
39087,Lawrence ,Ohio,38.59841852,-82.53677866,29728,30894,60622
39089,Licking ,Ohio,40.09160742,-82.48310247,84398,87895,172293
39091,Logan ,Ohio,40.38846053,-83.76584791,22336,22971,45307
39093,Lorain ,Ohio,41.29562989,-82.151197,151054,155659,306713
39095,Lucas ,Ohio,41.61991215,-83.65828978,209580,222799,432379
39097,Madison ,Ohio,39.89401713,-83.40020224,24041,19947,43988
39099,Mahoning ,Ohio,41.01464463,-80.77630521,112742,118322,231064
39101,Marion ,Ohio,40.5871872,-83.1608753,34700,30644,65344
39103,Medina ,Ohio,41.11759538,-81.89969226,87695,89562,177257
39105,Meigs ,Ohio,39.08222618,-82.02286627,11474,11686,23160
39107,Mercer ,Ohio,40.53994712,-84.62937243,20578,20228,40806
39109,Miami ,Ohio,40.05349578,-84.22886706,51847,52953,104800
39111,Monroe ,Ohio,39.72735638,-81.08292522,7012,7078,14090
39113,Montgomery ,Ohio,39.75460325,-84.29064547,256154,275880,532034
39115,Morgan ,Ohio,39.62035706,-81.85265616,7349,7353,14702
39117,Morrow ,Ohio,40.52408576,-82.79407836,17461,17515,34976
39119,Muskingum ,Ohio,39.96542793,-81.94437636,41719,44357,86076
39121,Noble ,Ohio,39.76596277,-81.45554731,8616,5827,14443
39123,Ottawa ,Ohio,41.53810172,-83.14085812,20215,20494,40709
39125,Paulding ,Ohio,41.11662437,-84.5802099,9413,9459,18872
39127,Perry ,Ohio,39.73711761,-82.23613255,18019,17966,35985
39129,Pickaway ,Ohio,39.64192237,-83.02437853,30202,27218,57420
39131,Pike ,Ohio,39.07731946,-83.06676554,13945,14269,28214
39133,Portage ,Ohio,41.16767273,-81.19740128,79741,82903,162644
39135,Preble ,Ohio,39.74153135,-84.64798274,20397,20810,41207
39137,Putnam ,Ohio,41.02212145,-84.13172734,16960,17009,33969
39139,Richland ,Ohio,40.77465634,-82.5364963,61593,59731,121324
39141,Ross ,Ohio,39.33759361,-83.05702254,40551,36500,77051
39143,Sandusky ,Ohio,41.3563112,-83.14618504,29394,29905,59299
39145,Scioto ,Ohio,38.80399918,-82.99282759,37604,38773,76377
39147,Seneca ,Ohio,41.12387678,-83.12768972,27649,27826,55475
39149,Shelby ,Ohio,40.33155428,-84.20475871,24657,24140,48797
39151,Stark ,Ohio,40.81388291,-81.36562803,181448,192027,373475
39153,Summit ,Ohio,41.12597541,-81.53216638,262858,278952,541810
39155,Trumbull ,Ohio,41.31718778,-80.76113752,98467,103327,201794
39157,Tuscarawas ,Ohio,40.4409398,-81.47375605,45411,47115,92526
39159,Union ,Ohio,40.29940584,-83.37157009,26847,28807,55654
39161,Van Wert ,Ohio,40.85540738,-84.58611591,13891,14390,28281
39163,Vinton ,Ohio,39.25097321,-82.4853429,6584,6527,13111
39165,Warren ,Ohio,39.42756521,-84.16676242,114030,112534,226564
39167,Washington ,Ohio,39.45531521,-81.49528548,29953,30718,60671
39169,Wayne ,Ohio,40.82887855,-81.88803484,57690,58518,116208
39171,Williams ,Ohio,41.56031495,-84.5881578,18266,18670,36936
39173,Wood ,Ohio,41.36169696,-83.62298917,63995,65941,129936
39175,Wyandot ,Ohio,40.84237998,-83.30437587,10923,11184,22107
40001,Adair ,Oklahoma,35.88390666,-94.65866372,10969,11144,22113
40003,Alfalfa ,Oklahoma,36.73103816,-98.32400838,3477,2380,5857
40005,Atoka ,Oklahoma,34.37372905,-96.0378243,7306,6568,13874
40007,Beaver ,Oklahoma,36.74964768,-100.47679,2756,2659,5415
40009,Beckham ,Oklahoma,35.26872726,-99.68190502,12222,10399,22621
40011,Blaine ,Oklahoma,35.87521066,-98.43344145,5038,4596,9634
40013,Bryan ,Oklahoma,33.96232617,-96.25979272,22228,23531,45759
40015,Caddo ,Oklahoma,35.17438243,-98.37514047,15361,13981,29342
40017,Canadian ,Oklahoma,35.54244313,-97.9823711,67922,68788,136710
40019,Carter ,Oklahoma,34.2508433,-97.28580139,23494,24912,48406
40021,Cherokee ,Oklahoma,35.90659476,-94.99967081,23863,24736,48599
40023,Choctaw ,Oklahoma,34.02659897,-95.55215862,7170,7716,14886
40025,Cimarron ,Oklahoma,36.74826238,-102.5177452,1095,1094,2189
40027,Cleveland ,Oklahoma,35.20304365,-97.32641881,138143,138590,276733
40029,Coal ,Oklahoma,34.58821863,-96.29782654,2818,2800,5618
40031,Comanche ,Oklahoma,34.66209885,-98.47166167,63585,58976,122561
40033,Cotton ,Oklahoma,34.29016491,-98.3722153,2984,2945,5929
40035,Craig ,Oklahoma,36.76172543,-95.20848408,7394,7099,14493
40037,Creek ,Oklahoma,35.90268123,-96.37095051,35189,35971,71160
40039,Custer ,Oklahoma,35.63888326,-99.00149222,14413,14796,29209
40041,Delaware ,Oklahoma,36.40819978,-94.80264841,20756,21356,42112
40043,Dewey ,Oklahoma,35.98768313,-99.00790941,2449,2469,4918
40045,Ellis ,Oklahoma,36.21836446,-99.75463794,1954,2118,4072
40047,Garfield ,Oklahoma,36.37905747,-97.78272302,31003,31187,62190
40049,Garvin ,Oklahoma,34.70456251,-97.3093234,13807,14016,27823
40051,Grady ,Oklahoma,35.01694168,-97.88411648,27348,27385,54733
40053,Grant ,Oklahoma,36.79613981,-97.78613156,2240,2178,4418
40055,Greer ,Oklahoma,34.93570494,-99.56081477,3419,2524,5943
40057,Harmon ,Oklahoma,34.7441062,-99.84627188,1299,1422,2721
40059,Harper ,Oklahoma,36.78870095,-99.66735662,1887,1960,3847
40061,Haskell ,Oklahoma,35.22484642,-95.11657786,6311,6393,12704
40063,Hughes ,Oklahoma,35.04833713,-96.25026112,7184,6276,13460
40065,Jackson ,Oklahoma,34.58797549,-99.41480703,12579,12805,25384
40067,Jefferson ,Oklahoma,34.11103507,-97.83587287,3104,3119,6223
40069,Johnston ,Oklahoma,34.31647681,-96.66066894,5458,5583,11041
40071,Kay ,Oklahoma,36.81800197,-97.14395855,22275,22605,44880
40073,Kingfisher ,Oklahoma,35.94539438,-97.94209346,7800,7818,15618
40075,Kiowa ,Oklahoma,34.91635356,-98.98085578,4463,4538,9001
40077,Latimer ,Oklahoma,34.87609208,-95.25039055,5312,5183,10495
40079,Le Flore ,Oklahoma,34.90028739,-94.70341271,25067,24842,49909
40081,Lincoln ,Oklahoma,35.70296411,-96.88091809,17326,17528,34854
40083,Logan ,Oklahoma,35.91932613,-97.44330445,22846,23198,46044
40085,Love ,Oklahoma,33.94988673,-97.24413092,4958,4975,9933
40087,McClain ,Oklahoma,35.00933605,-97.44430464,19191,19443,38634
40089,McCurtain ,Oklahoma,34.11540039,-94.77127654,16217,16749,32966
40091,McIntosh ,Oklahoma,35.37366087,-95.66681809,9784,10035,19819
40093,Major ,Oklahoma,36.31164359,-98.5359565,3795,3923,7718
40095,Marshall ,Oklahoma,34.02444645,-96.76912862,8117,8259,16376
40097,Mayes ,Oklahoma,36.3018662,-95.2308455,20435,20545,40980
40099,Murray ,Oklahoma,34.48233391,-97.06790209,6954,6921,13875
40101,Muskogee ,Oklahoma,35.61615094,-95.37959186,33709,35375,69084
40103,Noble ,Oklahoma,36.38858848,-97.23050671,5625,5786,11411
40105,Nowata ,Oklahoma,36.79847581,-95.6173967,5125,5258,10383
40107,Okfuskee ,Oklahoma,35.46545758,-96.32282583,6486,5629,12115
40109,Oklahoma ,Oklahoma,35.55152282,-97.40720976,382760,399291,782051
40111,Okmulgee ,Oklahoma,35.64666102,-95.96433944,19160,19729,38889
40113,Osage ,Oklahoma,36.62917021,-96.39849961,23675,23636,47311
40115,Ottawa ,Oklahoma,36.83552139,-94.81044687,15520,16046,31566
40117,Pawnee ,Oklahoma,36.31691342,-96.6992995,8216,8212,16428
40119,Payne ,Oklahoma,36.07730368,-96.97581188,41891,39621,81512
40121,Pittsburg ,Oklahoma,34.92393379,-95.74836557,22583,21799,44382
40123,Pontotoc ,Oklahoma,34.7280022,-96.68445231,18768,19590,38358
40125,Pottawatomie ,Oklahoma,35.20669944,-96.94833692,34410,37590,72000
40127,Pushmataha ,Oklahoma,34.41621545,-95.37579821,5439,5680,11119
40129,Roger Mills ,Oklahoma,35.68834006,-99.69576678,1814,1894,3708
40131,Rogers ,Oklahoma,36.37157301,-95.60435912,45246,45568,90814
40133,Seminole ,Oklahoma,35.16748504,-96.61552019,12278,12793,25071
40135,Sequoyah ,Oklahoma,35.49534179,-94.75520351,20382,20977,41359
40137,Stephens ,Oklahoma,34.48560274,-97.85148139,21328,22655,43983
40139,Texas ,Oklahoma,36.74789445,-101.4900522,11313,9808,21121
40141,Tillman ,Oklahoma,34.37283706,-98.92421126,3860,3655,7515
40143,Tulsa ,Oklahoma,36.12108603,-95.94146841,313659,329122,642781
40145,Wagoner ,Oklahoma,35.96108921,-95.52118349,38525,39325,77850
40147,Washington ,Oklahoma,36.71523618,-95.90436047,25253,26748,52001
40149,Washita ,Oklahoma,35.29037851,-98.99220959,5740,5692,11432
40151,Woods ,Oklahoma,36.76694403,-98.86510187,4924,4203,9127
40153,Woodward ,Oklahoma,36.42262179,-99.26501484,11122,9845,20967
41001,Baker ,Oregon,44.70915274,-117.6753042,8232,7752,15984
41003,Benton ,Oregon,44.49178904,-123.4292806,45317,44463,89780
41005,Clackamas ,Oregon,45.18803304,-122.2208636,199775,206013,405788
41007,Clatsop ,Oregon,45.99510198,-123.6558357,19166,19396,38562
41009,Columbia ,Oregon,45.94378932,-123.0882977,25506,25345,50851
41011,Coos ,Oregon,43.1742076,-124.0594242,31042,32266,63308
41013,Crook ,Oregon,44.14219192,-120.3565941,10916,11421,22337
41015,Curry ,Oregon,42.457637,-124.1567805,11043,11464,22507
41017,Deschutes ,Oregon,43.91503876,-121.2281018,89209,91431,180640
41019,Douglas ,Oregon,43.27968991,-123.1664605,53470,54853,108323
41021,Gilliam ,Oregon,45.37828399,-120.2107828,912,995,1907
41023,Grant ,Oregon,44.49156164,-119.0073148,3631,3552,7183
41025,Harney ,Oregon,43.06409853,-118.9679306,3657,3571,7228
41027,Hood River ,Oregon,45.51900469,-121.6510349,11528,11603,23131
41029,Jackson ,Oregon,42.43219221,-122.7284986,104458,109809,214267
41031,Jefferson ,Oregon,44.62941424,-121.1762919,12010,11133,23143
41033,Josephine ,Oregon,42.36547463,-123.5554762,41984,43497,85481
41035,Klamath ,Oregon,42.68641069,-121.6501515,33142,33168,66310
41037,Lake ,Oregon,42.79348531,-120.3873885,4192,3651,7843
41039,Lane ,Oregon,43.93881007,-122.8474847,181850,187032,368882
41041,Lincoln ,Oregon,44.64197269,-123.8682412,23050,24831,47881
41043,Linn ,Oregon,44.48887722,-122.5349884,60623,62247,122870
41045,Malheur ,Oregon,43.19341408,-117.62315,16581,13850,30431
41047,Marion ,Oregon,44.90331757,-122.5848977,167333,168220,335553
41049,Morrow ,Oregon,45.41893918,-119.5843617,5683,5532,11215
41051,Multnomah ,Oregon,45.546805,-122.4147504,395653,402994,798647
41053,Polk ,Oregon,44.90353634,-123.4132172,39563,41864,81427
41055,Sherman ,Oregon,45.40523761,-120.6893634,871,734,1605
41057,Tillamook ,Oregon,45.46370393,-123.7126734,13139,12937,26076
41059,Umatilla ,Oregon,45.59191976,-118.7368456,40110,36788,76898
41061,Union ,Oregon,45.31024619,-118.0087973,12911,13117,26028
41063,Wallowa ,Oregon,45.57989149,-117.1810506,3402,3522,6924
41065,Wasco ,Oregon,45.16000791,-121.1678425,12918,12948,25866
41067,Washington ,Oregon,45.56005545,-123.09838,287522,294299,581821
41069,Wheeler ,Oregon,44.72599234,-120.0275045,728,698,1426
41071,Yamhill ,Oregon,45.23262605,-123.308138,51894,51926,103820
42001,Adams ,Pennsylvania,39.87149161,-77.21787532,50224,51799,102023
42003,Allegheny ,Pennsylvania,40.46882294,-79.98119483,591630,633931,1225561
42005,Armstrong ,Pennsylvania,40.81230228,-79.46452696,33003,33328,66331
42007,Beaver ,Pennsylvania,40.68227518,-80.34928222,80949,85947,166896
42009,Bedford ,Pennsylvania,40.0065466,-78.49029673,24200,24411,48611
42011,Berks ,Pennsylvania,40.4163019,-75.92598091,204883,211759,416642
42013,Blair ,Pennsylvania,40.48098864,-78.34861174,60619,63223,123842
42015,Bradford ,Pennsylvania,41.78869707,-76.51538647,30206,31098,61304
42017,Bucks ,Pennsylvania,40.33696145,-75.10687581,307383,318987,626370
42019,Butler ,Pennsylvania,40.91172586,-79.91298415,92301,94265,186566
42021,Cambria ,Pennsylvania,40.49527138,-78.71371931,66180,68370,134550
42023,Cameron ,Pennsylvania,41.43672937,-78.2038804,2369,2317,4686
42025,Carbon ,Pennsylvania,40.91817437,-75.70881656,31783,32148,63931
42027,Centre ,Pennsylvania,40.91932379,-77.81995718,84972,76471,161443
42029,Chester ,Pennsylvania,39.97305906,-75.74844332,254746,262410,517156
42031,Clarion ,Pennsylvania,41.19239949,-79.42096732,18962,19865,38827
42033,Clearfield ,Pennsylvania,41.00016622,-78.47414043,41905,38311,80216
42035,Clinton ,Pennsylvania,41.23405214,-77.63814618,19278,19796,39074
42037,Columbia ,Pennsylvania,41.04870056,-76.40519317,31910,34310,66220
42039,Crawford ,Pennsylvania,41.68470618,-80.10624937,42194,43970,86164
42041,Cumberland ,Pennsylvania,40.16362479,-77.26553168,122321,125112,247433
42043,Dauphin ,Pennsylvania,40.41545319,-76.77946038,132864,141651,274515
42045,Delaware ,Pennsylvania,39.91669081,-75.39906782,271056,292471,563527
42047,Elk ,Pennsylvania,41.42523818,-78.64914534,15423,15185,30608
42049,Erie ,Pennsylvania,41.99259034,-80.03281626,136256,139716,275972
42051,Fayette ,Pennsylvania,39.91989346,-79.64733959,65327,66962,132289
42053,Forest ,Pennsylvania,41.51299393,-79.23602158,5807,1544,7351
42055,Franklin ,Pennsylvania,39.927404,-77.72128245,75503,78248,153751
42057,Fulton ,Pennsylvania,39.92535653,-78.11268553,7360,7146,14506
42059,Greene ,Pennsylvania,39.85383496,-80.22292248,19304,17840,37144
42061,Huntingdon ,Pennsylvania,40.41695423,-77.98120761,24052,21369,45421
42063,Indiana ,Pennsylvania,40.65207102,-79.08754514,42835,42920,85755
42065,Jefferson ,Pennsylvania,41.12815865,-78.99943527,21887,22197,44084
42067,Juniata ,Pennsylvania,40.5310531,-77.40217996,12238,12324,24562
42069,Lackawanna ,Pennsylvania,41.43681894,-75.60920994,102480,108974,211454
42071,Lancaster ,Pennsylvania,40.04243434,-76.24772861,263680,274667,538347
42073,Lawrence ,Pennsylvania,40.99124715,-80.33422809,42321,45061,87382
42075,Lebanon ,Pennsylvania,40.36722643,-76.45771025,67999,70675,138674
42077,Lehigh ,Pennsylvania,40.61270161,-75.59232908,177051,185562,362613
42079,Luzerne ,Pennsylvania,41.17702013,-75.9890141,156972,160912,317884
42081,Lycoming ,Pennsylvania,41.3434018,-77.0645311,56457,58402,114859
42083,McKean ,Pennsylvania,41.80769828,-78.56904735,21531,20275,41806
42085,Mercer ,Pennsylvania,41.30218692,-80.25768117,55546,57084,112630
42087,Mifflin ,Pennsylvania,40.61042365,-77.61703355,22744,23618,46362
42089,Monroe ,Pennsylvania,41.05805568,-75.33952264,82895,84691,167586
42091,Montgomery ,Pennsylvania,40.21081846,-75.36727894,399358,421943,821301
42093,Montour ,Pennsylvania,41.02786679,-76.65858584,8846,9448,18294
42095,Northampton ,Pennsylvania,40.75417394,-75.30755965,148366,153412,301778
42097,Northumberland ,Pennsylvania,40.85202998,-76.70934449,46545,45780,92325
42099,Perry ,Pennsylvania,40.39839537,-77.26230916,23184,22740,45924
42101,Philadelphia ,Pennsylvania,40.00766686,-75.13389862,745543,829979,1575522
42103,Pike ,Pennsylvania,41.33199215,-75.03383326,28072,27426,55498
42105,Potter ,Pennsylvania,41.74492726,-77.89581311,8475,8462,16937
42107,Schuylkill ,Pennsylvania,40.70581319,-76.21598942,73333,70222,143555
42109,Snyder ,Pennsylvania,40.76983942,-77.07016619,20063,20403,40466
42111,Somerset ,Pennsylvania,39.97246804,-79.02825923,39038,35911,74949
42113,Sullivan ,Pennsylvania,41.44615844,-76.51223502,3253,2924,6177
42115,Susquehanna ,Pennsylvania,41.82137626,-75.80070292,20794,20546,41340
42117,Tioga ,Pennsylvania,41.77217214,-77.25426619,20516,20710,41226
42119,Union ,Pennsylvania,40.96300208,-77.06222761,24802,20312,45114
42121,Venango ,Pennsylvania,41.40098984,-79.75795405,25842,26534,52376
42123,Warren ,Pennsylvania,41.8145093,-79.27412917,20013,20022,40035
42125,Washington ,Pennsylvania,40.18940354,-80.24823903,101709,105838,207547
42127,Wayne ,Pennsylvania,41.64872959,-75.30327044,27278,24258,51536
42129,Westmoreland ,Pennsylvania,40.31072399,-79.46696261,173251,181500,354751
42131,Wyoming ,Pennsylvania,41.51836366,-76.0165963,13887,13701,27588
42133,York ,Pennsylvania,39.9199616,-76.72652516,219415,224599,444014
44001,Bristol ,Rhode Island,41.71725323,-71.28402169,23570,25330,48900
44003,Kent ,Rhode Island,41.67218098,-71.59307645,79219,84642,163861
44005,Newport ,Rhode Island,41.55638686,-71.23679569,40948,42127,83075
44007,Providence ,Rhode Island,41.87214104,-71.57999403,308485,326048,634533
44009,Washington ,Rhode Island,41.46972321,-71.62254154,61110,65132,126242
45001,Abbeville ,South Carolina,34.2225929,-82.45916543,11966,12691,24657
45003,Aiken ,South Carolina,33.54424832,-81.63469364,80764,86162,166926
45005,Allendale ,South Carolina,32.98815287,-81.35830038,4913,4301,9214
45007,Anderson ,South Carolina,34.51926406,-82.63776964,94565,101430,195995
45009,Bamberg ,South Carolina,33.21479875,-81.05424206,7113,7487,14600
45011,Barnwell ,South Carolina,33.26605045,-81.43500078,10300,11277,21577
45013,Beaufort ,South Carolina,32.38554045,-80.73021039,89979,92679,182658
45015,Berkeley ,South Carolina,33.19733029,-79.95216443,103989,105076,209065
45017,Calhoun ,South Carolina,33.67488299,-80.78029516,7013,7700,14713
45019,Charleston ,South Carolina,32.83460089,-79.95313718,191191,203517,394708
45021,Cherokee ,South Carolina,35.04813183,-81.62045078,27529,29182,56711
45023,Chester ,South Carolina,34.6920387,-81.15952739,15747,16579,32326
45025,Chesterfield ,South Carolina,34.63980202,-80.15873739,22642,23382,46024
45027,Clarendon ,South Carolina,33.66579329,-80.21641797,16740,17277,34017
45029,Colleton ,South Carolina,32.86361553,-80.66689284,17958,19610,37568
45031,Darlington ,South Carolina,34.33251449,-79.95771336,31693,35560,67253
45033,Dillon ,South Carolina,34.39149489,-79.37892527,14567,16304,30871
45035,Dorchester ,South Carolina,33.07931222,-80.40667286,75635,79839,155474
45037,Edgefield ,South Carolina,33.77223475,-81.96643733,14363,12406,26769
45039,Fairfield ,South Carolina,34.39509797,-81.12123135,10854,11858,22712
45041,Florence ,South Carolina,34.02447935,-79.70295432,64599,73962,138561
45043,Georgetown ,South Carolina,33.43429813,-79.33230241,29133,32472,61605
45045,Greenville ,South Carolina,34.89436839,-82.37074306,241853,256549,498402
45047,Greenwood ,South Carolina,34.15382164,-82.12592286,32553,37711,70264
45049,Hampton ,South Carolina,32.77629138,-81.1406948,10247,9560,19807
45051,Horry ,South Carolina,33.92151441,-78.99653996,155100,165815,320915
45053,Jasper ,South Carolina,32.43671968,-81.03151289,14070,13830,27900
45055,Kershaw ,South Carolina,34.33879136,-80.59021048,31261,33100,64361
45057,Lancaster ,South Carolina,34.68669152,-80.70542557,43592,45954,89546
45059,Laurens ,South Carolina,34.48356905,-82.00594608,32455,34255,66710
45061,Lee ,South Carolina,34.16332184,-80.25449509,9164,8442,17606
45063,Lexington ,South Carolina,33.90228761,-81.27218397,139495,146821,286316
45065,McCormick ,South Carolina,33.89957688,-82.30987367,5334,4272,9606
45067,Marion ,South Carolina,34.08007952,-79.36249553,14655,16907,31562
45069,Marlboro ,South Carolina,34.60198441,-79.67861829,14236,12895,27131
45071,Newberry ,South Carolina,34.28981464,-81.60013226,18536,19532,38068
45073,Oconee ,South Carolina,34.75343468,-83.06580537,37801,38895,76696
45075,Orangeburg ,South Carolina,33.43899661,-80.80029802,41524,46930,88454
45077,Pickens ,South Carolina,34.88730959,-82.725238,61190,61556,122746
45079,Richland ,South Carolina,34.02184955,-80.90309595,197835,210428,408263
45081,Saluda ,South Carolina,34.00609577,-81.72689929,10200,10099,20299
45083,Spartanburg ,South Carolina,34.93124008,-81.99081999,146535,155660,302195
45085,Sumter ,South Carolina,33.91620014,-80.38225564,51474,55521,106995
45087,Union ,South Carolina,34.68927423,-81.61940847,13228,14416,27644
45089,Williamsburg ,South Carolina,33.61991094,-79.72772085,15307,16487,31794
45091,York ,South Carolina,34.97473318,-81.18437069,124828,133813,258641
46003,Aurora ,South Dakota,43.71801281,-98.56154178,1448,1311,2759
46005,Beadle ,South Dakota,44.41447696,-98.27811793,9460,8914,18374
46007,Bennett ,South Dakota,43.19499086,-101.6640257,1620,1817,3437
46009,Bon Homme ,South Dakota,42.98846678,-97.8846206,4071,2898,6969
46011,Brookings ,South Dakota,44.3696625,-96.79043335,17538,16701,34239
46013,Brown ,South Dakota,45.58979072,-98.35159798,19060,19780,38840
46015,Brule ,South Dakota,43.71807395,-99.08093329,2598,2658,5256
46017,Buffalo ,South Dakota,44.07628784,-99.20483202,1018,1035,2053
46019,Butte ,South Dakota,44.90577208,-103.5079283,5083,5094,10177
46021,Campbell ,South Dakota,45.77117219,-100.051612,753,682,1435
46023,Charles Mix ,South Dakota,43.20792553,-98.58790664,4693,4651,9344
46025,Clark ,South Dakota,44.85824066,-97.72950099,1876,1797,3673
46027,Clay ,South Dakota,42.91468168,-96.97564574,6879,7046,13925
46029,Codington ,South Dakota,44.97785073,-97.18862734,14080,13913,27993
46031,Corson ,South Dakota,45.7086088,-101.1969078,2113,2055,4168
46033,Custer ,South Dakota,43.67763221,-103.4515328,4286,4287,8573
46035,Davison ,South Dakota,43.67472434,-98.14595065,9963,9938,19901
46037,Day ,South Dakota,45.36714609,-97.60742179,2857,2649,5506
46039,Deuel ,South Dakota,44.76004316,-96.66801057,2255,2051,4306
46041,Dewey ,South Dakota,45.15663919,-100.8718417,2869,2910,5779
46043,Douglas ,South Dakota,43.38691872,-98.36607792,1417,1513,2930
46045,Edmunds ,South Dakota,45.41878905,-99.21532081,2008,1932,3940
46047,Fall River ,South Dakota,43.23937412,-103.5275291,3404,3370,6774
46049,Faulk ,South Dakota,45.0710147,-99.14528617,1165,1157,2322
46051,Grant ,South Dakota,45.17192593,-96.7676823,3756,3461,7217
46053,Gregory ,South Dakota,43.19241631,-99.18561069,2144,2057,4201
46055,Haakon ,South Dakota,44.29444173,-101.5399252,1012,1070,2082
46057,Hamlin ,South Dakota,44.67376049,-97.18831893,3091,2909,6000
46059,Hand ,South Dakota,44.54777521,-99.00492864,1674,1627,3301
46061,Hanson ,South Dakota,43.67481695,-97.78728453,1709,1688,3397
46063,Harding ,South Dakota,45.58032483,-103.4958361,695,616,1311
46065,Hughes ,South Dakota,44.38901942,-99.99600978,8610,9007,17617
46067,Hutchinson ,South Dakota,43.33486552,-97.75442347,3605,3710,7315
46069,Hyde ,South Dakota,44.54730052,-99.48705852,666,665,1331
46071,Jackson ,South Dakota,43.69425598,-101.6281301,1611,1676,3287
46073,Jerauld ,South Dakota,44.0663338,-98.62965784,996,1033,2029
46075,Jones ,South Dakota,43.96059288,-100.6897133,364,371,735
46077,Kingsbury ,South Dakota,44.3695974,-97.49150301,2537,2430,4967
46079,Lake ,South Dakota,44.02205748,-97.12935741,6569,6005,12574
46081,Lawrence ,South Dakota,44.35863267,-103.7922879,12595,12639,25234
46083,Lincoln ,South Dakota,43.27892778,-96.72176974,27152,27762,54914
46085,Lyman ,South Dakota,43.89582568,-99.84737284,2017,1852,3869
46087,McCook ,South Dakota,43.67429949,-97.36844463,2771,2740,5511
46089,McPherson ,South Dakota,45.76640479,-99.22140805,1192,1172,2364
46091,Marshall ,South Dakota,45.75855963,-97.59864244,2527,2368,4895
46093,Meade ,South Dakota,44.56681435,-102.7168461,14349,13075,27424
46095,Mellette ,South Dakota,43.58125835,-100.7599813,1026,1029,2055
46097,Miner ,South Dakota,44.02195241,-97.61019617,1152,1077,2229
46099,Minnehaha ,South Dakota,43.67415648,-96.79147194,94085,92664,186749
46101,Moody ,South Dakota,44.02196926,-96.67088888,3302,3204,6506
46102,Oglala Lakota ,South Dakota,43.33554852,-102.5516433,6989,7346,14335
46103,Pennington ,South Dakota,44.00373191,-102.823802,54990,54304,109294
46105,Perkins ,South Dakota,45.49046757,-102.4756931,1474,1433,2907
46107,Potter ,South Dakota,45.06451379,-99.95722927,1179,1147,2326
46109,Roberts ,South Dakota,45.62956821,-96.94609796,5290,4995,10285
46111,Sanborn ,South Dakota,44.02341733,-98.09134329,1233,1155,2388
46115,Spink ,South Dakota,44.9380237,-98.34620254,3280,3263,6543
46117,Stanley ,South Dakota,44.41230092,-100.7359085,1549,1448,2997
46119,Sully ,South Dakota,44.71556957,-100.1322321,698,633,1331
46121,Todd ,South Dakota,43.19338499,-100.7184504,4979,5167,10146
46123,Tripp ,South Dakota,43.34593249,-99.8839593,2719,2749,5468
46125,Turner ,South Dakota,43.31089408,-97.14867177,4138,4126,8264
46127,Union ,South Dakota,42.83257501,-96.65602662,7693,7484,15177
46129,Walworth ,South Dakota,45.42994288,-100.0315351,2726,2784,5510
46135,Yankton ,South Dakota,43.00897405,-97.39476434,11705,11012,22717
46137,Ziebach ,South Dakota,44.9804141,-101.6657997,1398,1416,2814
47001,Anderson ,Tennessee,36.11845321,-84.19845817,36904,38871,75775
47003,Bedford ,Tennessee,35.51380346,-86.45888636,23409,24149,47558
47005,Benton ,Tennessee,36.0697893,-88.068305,7887,8225,16112
47007,Bledsoe ,Tennessee,35.59640888,-85.20516156,8517,6085,14602
47009,Blount ,Tennessee,35.68721821,-83.92551694,62290,66153,128443
47011,Bradley ,Tennessee,35.15411015,-84.85959765,50905,53652,104557
47013,Campbell ,Tennessee,36.40352623,-84.14940468,19306,20381,39687
47015,Cannon ,Tennessee,35.8086705,-86.06173582,6899,7077,13976
47017,Carroll ,Tennessee,35.97315669,-88.45027575,13692,14326,28018
47019,Carter ,Tennessee,36.29276311,-82.12747504,27618,28773,56391
47021,Cheatham ,Tennessee,36.26112827,-87.08674199,19817,20112,39929
47023,Chester ,Tennessee,35.42175442,-88.61345399,8207,8943,17150
47025,Claiborne ,Tennessee,36.4858577,-83.66041903,15361,16252,31613
47027,Clay ,Tennessee,36.55114004,-85.54391543,3771,3915,7686
47029,Cocke ,Tennessee,35.9254348,-83.12118725,17105,18231,35336
47031,Coffee ,Tennessee,35.49061692,-86.07475201,26640,27891,54531
47033,Crockett ,Tennessee,35.81353438,-89.13950383,6907,7592,14499
47035,Cumberland ,Tennessee,35.9503717,-84.99836908,28746,29888,58634
47037,Davidson ,Tennessee,36.16953536,-86.78479193,329948,354069,684017
47039,Decatur ,Tennessee,35.60304809,-88.10879294,5788,5895,11683
47041,DeKalb ,Tennessee,35.97985395,-85.83277649,9750,9851,19601
47043,Dickson ,Tennessee,36.14903546,-87.35666317,25458,26530,51988
47045,Dyer ,Tennessee,36.05905083,-89.4137728,18157,19419,37576
47047,Fayette ,Tennessee,35.19711031,-89.4143725,19510,20182,39692
47049,Fentress ,Tennessee,36.38047877,-84.93244393,8893,9101,17994
47051,Franklin ,Tennessee,35.15503589,-86.09218777,20414,21098,41512
47053,Gibson ,Tennessee,35.99660853,-88.93261977,23688,25487,49175
47055,Giles ,Tennessee,35.20213297,-87.03477626,14246,14921,29167
47057,Grainger ,Tennessee,36.27625767,-83.5096187,11465,11548,23013
47059,Greene ,Tennessee,36.1753376,-82.84582904,33550,35119,68669
47061,Grundy ,Tennessee,35.3883915,-85.72259544,6571,6760,13331
47063,Hamblen ,Tennessee,36.2171391,-83.2666799,31141,32599,63740
47065,Hamilton ,Tennessee,35.18084673,-85.16476648,172447,185099,357546
47067,Hancock ,Tennessee,36.52361268,-83.22189584,3293,3292,6585
47069,Hardeman ,Tennessee,35.20683887,-88.99307462,14088,11474,25562
47071,Hardin ,Tennessee,35.19869821,-88.18448954,12606,13165,25771
47073,Hawkins ,Tennessee,36.44117868,-82.94467038,27582,28820,56402
47075,Haywood ,Tennessee,35.58323049,-89.28381363,8246,9533,17779
47077,Henderson ,Tennessee,35.6542319,-88.38802704,13446,14413,27859
47079,Henry ,Tennessee,36.33177882,-88.30127838,15554,16725,32279
47081,Hickman ,Tennessee,35.80323233,-87.47333767,12910,11768,24678
47083,Houston ,Tennessee,36.28597983,-87.7170735,4066,4110,8176
47085,Humphreys ,Tennessee,36.04082113,-87.77562475,9013,9305,18318
47087,Jackson ,Tennessee,36.35920579,-85.67315642,5826,5789,11615
47089,Jefferson ,Tennessee,36.05098084,-83.44630109,26099,27148,53247
47091,Johnson ,Tennessee,36.45493975,-81.85176016,9682,8107,17789
47093,Knox ,Tennessee,35.99321037,-83.93710155,221667,234518,456185
47095,Lake ,Tennessee,36.33524746,-89.49353492,4642,2884,7526
47097,Lauderdale ,Tennessee,35.76098742,-89.63145197,13505,12792,26297
47099,Lawrence ,Tennessee,35.21735801,-87.39557646,21088,21849,42937
47101,Lewis ,Tennessee,35.52727339,-87.49310383,5735,6221,11956
47103,Lincoln ,Tennessee,35.14052807,-86.58896912,16620,17091,33711
47105,Loudon ,Tennessee,35.73479238,-84.3118493,25234,26376,51610
47107,McMinn ,Tennessee,35.4247481,-84.61746888,25537,27236,52773
47109,McNairy ,Tennessee,35.17550901,-88.56360573,12685,13218,25903
47111,Macon ,Tennessee,36.53200013,-86.00727161,11544,11943,23487
47113,Madison ,Tennessee,35.60814497,-88.838459,46137,51545,97682
47115,Marion ,Tennessee,35.12932436,-85.62203781,13832,14585,28417
47117,Marshall ,Tennessee,35.46886024,-86.76500946,15877,16392,32269
47119,Maury ,Tennessee,35.61694024,-87.07702168,43111,46665,89776
47121,Meigs ,Tennessee,35.51282189,-84.81339168,5937,6025,11962
47123,Monroe ,Tennessee,35.4426553,-84.25274183,22701,23175,45876
47125,Montgomery ,Tennessee,36.49688793,-87.38281328,98123,98264,196387
47127,Moore ,Tennessee,35.28462036,-86.3587359,3101,3221,6322
47129,Morgan ,Tennessee,36.13500745,-84.64919798,12050,9546,21596
47131,Obion ,Tennessee,36.3582109,-89.14878276,14647,15873,30520
47133,Overton ,Tennessee,36.34498193,-85.28808425,10857,11147,22004
47135,Perry ,Tennessee,35.64263596,-87.85894818,3978,3934,7912
47137,Pickett ,Tennessee,36.55840267,-85.07488149,2575,2513,5088
47139,Polk ,Tennessee,35.11988151,-84.52331997,8369,8413,16782
47141,Putnam ,Tennessee,36.14081595,-85.49515123,37707,38733,76440
47143,Rhea ,Tennessee,35.60871372,-84.92440219,16106,16522,32628
47145,Roane ,Tennessee,35.84785753,-84.52324012,25931,26966,52897
47147,Robertson ,Tennessee,36.52546696,-86.87058162,34287,35057,69344
47149,Rutherford ,Tennessee,35.84271817,-86.41673423,151446,155682,307128
47151,Scott ,Tennessee,36.42850034,-84.50348796,10855,11099,21954
47153,Sequatchie ,Tennessee,35.37115163,-85.41057779,7331,7399,14730
47155,Sevier ,Tennessee,35.78463242,-83.52418358,47281,49006,96287
47157,Shelby ,Tennessee,35.18398479,-89.89554942,445994,491011,937005
47159,Smith ,Tennessee,36.25050642,-85.95671183,9675,9783,19458
47161,Stewart ,Tennessee,36.50115768,-87.83844699,6631,6670,13301
47163,Sullivan ,Tennessee,36.51291121,-82.30418898,76050,80684,156734
47165,Sumner ,Tennessee,36.46937757,-86.46037841,87811,91662,179473
47167,Tipton ,Tennessee,35.49687298,-89.75921158,30240,31206,61446
47169,Trousdale ,Tennessee,36.39205657,-86.15676836,5302,4271,9573
47171,Unicoi ,Tennessee,36.11074118,-82.43230579,8895,8885,17780
47173,Union ,Tennessee,36.28787239,-83.83752825,9556,9737,19293
47175,Van Buren ,Tennessee,35.69597099,-85.45263163,2882,2822,5704
47177,Warren ,Tennessee,35.67869889,-85.7785048,20091,20363,40454
47179,Washington ,Tennessee,36.2932856,-82.4974285,61851,65204,127055
47181,Wayne ,Tennessee,35.2399113,-87.78805011,9186,7463,16649
47183,Weakley ,Tennessee,36.29826079,-88.7178007,16541,17085,33626
47185,White ,Tennessee,35.92635874,-85.45520781,12982,13598,26580
47187,Williamson ,Tennessee,35.89383743,-86.89864309,107021,111627,218648
47189,Wilson ,Tennessee,36.15485372,-86.29774249,65056,67607,132663
48001,Anderson ,Texas,31.8133186,-95.65253752,35412,22451,57863
48003,Andrews ,Texas,32.30503031,-102.6377374,9102,8716,17818
48005,Angelina ,Texas,31.2547741,-94.61185398,42659,44948,87607
48007,Aransas ,Texas,28.12486766,-96.99339413,12026,12737,24763
48009,Archer ,Texas,33.61526367,-98.68766806,4326,4463,8789
48011,Armstrong ,Texas,34.96494292,-101.3573839,960,956,1916
48013,Atascosa ,Texas,28.8935092,-98.52715241,24398,24430,48828
48015,Austin ,Texas,29.88700671,-96.27789857,14684,14881,29565
48017,Bailey ,Texas,34.0685777,-102.8298737,3640,3452,7092
48019,Bandera ,Texas,29.74721062,-99.24630536,11032,10731,21763
48021,Bastrop ,Texas,30.10360343,-97.3120142,42014,40563,82577
48023,Baylor ,Texas,33.61650448,-99.2135389,1752,1839,3591
48025,Bee ,Texas,28.41737149,-97.74116666,19911,12780,32691
48027,Bell ,Texas,31.03766574,-97.47823822,170918,171318,342236
48029,Bexar ,Texas,29.44893847,-98.52000518,950030,975835,1925865
48031,Blanco ,Texas,30.26635537,-98.39987955,5781,5498,11279
48033,Borden ,Texas,32.74363988,-101.4317174,346,319,665
48035,Bosque ,Texas,31.9003849,-97.63433619,8935,9187,18122
48037,Bowie ,Texas,33.44578126,-94.42335845,47275,46583,93858
48039,Brazoria ,Texas,29.18965497,-95.45192577,179060,174939,353999
48041,Brazos ,Texas,30.66080441,-96.30238878,111074,108119,219193
48043,Brewster ,Texas,29.81194101,-103.2517409,4558,4658,9216
48045,Briscoe ,Texas,34.53027499,-101.2085526,831,715,1546
48047,Brooks ,Texas,27.03158304,-98.21874157,3724,3456,7180
48049,Brown ,Texas,31.77424858,-98.99978019,18774,19060,37834
48051,Burleson ,Texas,30.49244389,-96.62140186,8977,8886,17863
48053,Burnet ,Texas,30.78834089,-98.18244668,22642,23108,45750
48055,Caldwell ,Texas,29.83709225,-97.61999433,20893,20508,41401
48057,Calhoun ,Texas,28.50665699,-96.60200825,11062,10745,21807
48059,Callahan ,Texas,32.297644,-99.37347936,6763,7007,13770
48061,Cameron ,Texas,26.1334522,-97.51799288,204788,216962,421750
48063,Camp ,Texas,32.97320759,-94.97851988,6220,6593,12813
48065,Carson ,Texas,35.40349093,-101.3542015,2820,3212,6032
48067,Cass ,Texas,33.07753587,-94.34354434,14692,15395,30087
48069,Castro ,Texas,34.52988759,-102.2616705,3905,3882,7787
48071,Chambers ,Texas,29.73859764,-94.6110006,20377,19915,40292
48073,Cherokee ,Texas,31.8369674,-95.16518981,26607,25296,51903
48075,Childress ,Texas,34.52914004,-100.2076179,4449,2777,7226
48077,Clay ,Texas,33.7855075,-98.20851378,5195,5192,10387
48079,Cochran ,Texas,33.60418291,-102.8285091,1491,1413,2904
48081,Coke ,Texas,31.88860759,-100.5298803,1606,1669,3275
48083,Coleman ,Texas,31.77320727,-99.45363425,4220,4171,8391
48085,Collin ,Texas,33.1879318,-96.57239128,464248,480102,944350
48087,Collingsworth ,Texas,34.96483239,-100.2700123,1496,1500,2996
48089,Colorado ,Texas,29.62082122,-96.5262677,10538,10484,21022
48091,Comal ,Texas,29.80818633,-98.27827042,66793,68304,135097
48093,Comanche ,Texas,31.94796879,-98.55822762,6738,6757,13495
48095,Concho ,Texas,31.32657452,-99.86402949,2802,1431,4233
48097,Cooke ,Texas,33.63926014,-97.21258729,19660,19911,39571
48099,Coryell ,Texas,31.39090691,-97.79922004,37630,37759,75389
48101,Cottle ,Texas,34.07764342,-100.2787921,792,831,1623
48103,Crane ,Texas,31.42861673,-102.5155929,2511,2328,4839
48105,Crockett ,Texas,30.72308929,-101.4120493,1771,1862,3633
48107,Crosby ,Texas,33.61466494,-101.2999866,2921,2940,5861
48109,Culberson ,Texas,31.44706881,-104.5173142,1231,1010,2241
48111,Dallam ,Texas,36.27788094,-102.6022134,3795,3448,7243
48113,Dallas ,Texas,32.76663248,-96.77787632,1275226,1311326,2586552
48115,Dawson ,Texas,32.74255537,-101.9476464,7235,5729,12964
48117,Deaf Smith ,Texas,34.96603186,-102.6049839,9507,9392,18899
48119,Delta ,Texas,33.38627687,-95.67233843,2527,2688,5215
48121,Denton ,Texas,33.20524384,-97.11700783,397140,409907,807047
48123,DeWitt ,Texas,29.08206563,-97.35674315,10577,9858,20435
48125,Dickens ,Texas,33.61645937,-100.7789112,1143,1073,2216
48127,Dimmit ,Texas,28.42257684,-99.7566396,5186,5477,10663
48129,Donley ,Texas,34.96543711,-100.8139823,1634,1753,3387
48131,Duval ,Texas,27.68138223,-98.50887121,5758,5597,11355
48133,Eastland ,Texas,32.32707861,-98.83230264,9245,9025,18270
48135,Ector ,Texas,31.8691863,-102.5428806,80249,78093,158342
48137,Edwards ,Texas,29.98271755,-100.3047648,1062,993,2055
48139,Ellis ,Texas,32.34842574,-96.79450537,83184,85654,168838
48141,El Paso ,Texas,31.76857317,-106.234837,411682,425972,837654
48143,Erath ,Texas,32.23625257,-98.21794279,20216,21266,41482
48145,Falls ,Texas,31.25327535,-96.93586082,8189,9110,17299
48147,Fannin ,Texas,33.59383164,-96.10686472,18034,16141,34175
48149,Fayette ,Texas,29.87677434,-96.91977793,12351,12715,25066
48151,Fisher ,Texas,32.7428132,-100.4021866,1879,2004,3883
48153,Floyd ,Texas,34.07242705,-101.3032349,2885,2987,5872
48155,Foard ,Texas,33.97458655,-99.77800364,712,696,1408
48157,Fort Bend ,Texas,29.52749688,-95.77089552,363177,376165,739342
48159,Franklin ,Texas,33.17552533,-95.2184343,5362,5317,10679
48161,Freestone ,Texas,31.70490445,-96.14908242,10163,9546,19709
48163,Frio ,Texas,28.8677854,-99.10820434,11580,7814,19394
48165,Gaines ,Texas,32.74075229,-102.6351781,10320,10001,20321
48167,Galveston ,Texas,29.39308628,-94.96288314,161269,165820,327089
48169,Garza ,Texas,33.17986645,-101.2984568,4070,2218,6288
48171,Gillespie ,Texas,30.31803705,-98.94655484,12731,13477,26208
48173,Glasscock ,Texas,31.86938032,-101.5207736,787,643,1430
48175,Goliad ,Texas,28.65708622,-97.42644709,3734,3797,7531
48177,Gonzales ,Texas,29.45668685,-97.49253831,10448,10219,20667
48179,Gray ,Texas,35.40120017,-100.8125965,11903,10782,22685
48181,Grayson ,Texas,33.62677605,-96.6777263,62737,65823,128560
48183,Gregg ,Texas,32.48046859,-94.81695462,60208,63286,123494
48185,Grimes ,Texas,30.5434716,-95.98550895,14892,12738,27630
48187,Guadalupe ,Texas,29.5830584,-97.94858615,76850,78287,155137
48189,Hale ,Texas,34.07050536,-101.8268848,17751,16362,34113
48191,Hall ,Texas,34.53078602,-100.6811091,1546,1528,3074
48193,Hamilton ,Texas,31.7048081,-98.11069179,4070,4199,8269
48195,Hansford ,Texas,36.27742943,-101.3545724,2783,2764,5547
48197,Hardeman ,Texas,34.29024537,-99.74569206,1938,2014,3952
48199,Hardin ,Texas,30.33238318,-94.39021268,27342,29037,56379
48201,Harris ,Texas,29.85773886,-95.39360995,2288295,2314228,4602523
48203,Harrison ,Texas,32.54813741,-94.37146798,32556,34089,66645
48205,Hartley ,Texas,35.83999284,-102.6029205,3411,2356,5767
48207,Haskell ,Texas,33.17823036,-99.73030384,3071,2738,5809
48209,Hays ,Texas,30.05814506,-98.03106419,101636,102514,204150
48211,Hemphill ,Texas,35.83753899,-100.2706124,1965,2096,4061
48213,Henderson ,Texas,32.21189862,-95.85359425,39097,41363,80460
48215,Hidalgo ,Texas,26.39688287,-98.18120449,415443,433946,849389
48217,Hill ,Texas,31.99067987,-97.13242892,17603,17796,35399
48219,Hockley ,Texas,33.60762985,-102.3431891,11428,11734,23162
48221,Hood ,Texas,32.42995059,-97.83230556,28004,28897,56901
48223,Hopkins ,Texas,33.1495544,-95.56395296,17801,18439,36240
48225,Houston ,Texas,31.31773296,-95.42268102,12432,10523,22955
48227,Howard ,Texas,32.30616438,-101.4355855,20732,15935,36667
48229,Hudspeth ,Texas,31.45623373,-105.3864675,2019,2079,4098
48231,Hunt ,Texas,33.12358392,-96.08547687,45279,46873,92152
48233,Hutchinson ,Texas,35.84003727,-101.3546811,10797,10774,21571
48235,Irion ,Texas,31.30391434,-100.9823901,836,688,1524
48237,Jack ,Texas,33.23346766,-98.17246749,4987,3855,8842
48239,Jackson ,Texas,28.95423066,-96.57763243,7226,7594,14820
48241,Jasper ,Texas,30.74399383,-94.02510391,17501,18003,35504
48243,Jeff Davis ,Texas,30.71537552,-104.1399602,1114,1120,2234
48245,Jefferson ,Texas,29.8840516,-94.16292952,130660,124550,255210
48247,Jim Hogg ,Texas,27.0434197,-98.69733191,2550,2732,5282
48249,Jim Wells ,Texas,27.73135077,-98.08986677,20178,21014,41192
48251,Johnson ,Texas,32.37901182,-97.36634841,81568,81907,163475
48253,Jones ,Texas,32.73989346,-99.87875143,12507,7384,19891
48255,Karnes ,Texas,28.90572925,-97.85938066,9133,6254,15387
48257,Kaufman ,Texas,32.59931225,-96.28778549,58360,60550,118910
48259,Kendall ,Texas,29.94465924,-98.71155152,20415,21567,41982
48261,Kenedy ,Texas,26.92854487,-97.70173623,286,309,595
48263,Kent ,Texas,33.18131269,-100.7776243,327,422,749
48265,Kerr ,Texas,30.06145526,-99.35001216,24886,26479,51365
48267,Kimble ,Texas,30.48679744,-99.74868811,2154,2254,4408
48269,King ,Texas,33.61654785,-100.25584,118,110,228
48271,Kinney ,Texas,29.35008456,-100.4179854,2290,1385,3675
48273,Kleberg ,Texas,27.43370654,-97.72728298,16052,15373,31425
48275,Knox ,Texas,33.60609256,-99.74142702,1853,1880,3733
48277,Lamar ,Texas,33.66725053,-95.57119722,23917,25615,49532
48279,Lamb ,Texas,34.06860858,-102.3517172,6710,6552,13262
48281,Lampasas ,Texas,31.19620955,-98.24144938,10187,10453,20640
48283,La Salle ,Texas,28.34514357,-99.09958589,4408,3001,7409
48285,Lavaca ,Texas,29.38434069,-96.93012561,9684,10257,19941
48287,Lee ,Texas,30.31065368,-96.96569099,8558,8394,16952
48289,Leon ,Texas,31.29650397,-95.99569629,8602,8496,17098
48291,Liberty ,Texas,30.15161524,-94.81220758,40439,41423,81862
48293,Limestone ,Texas,31.5454568,-96.58050712,12056,11459,23515
48295,Lipscomb ,Texas,36.27763953,-100.2731484,1840,1629,3469
48297,Live Oak ,Texas,28.35140099,-98.12482865,6634,5489,12123
48299,Llano ,Texas,30.70573837,-98.6841223,10138,10502,20640
48301,Loving ,Texas,31.84927477,-103.5800104,58,44,102
48303,Lubbock ,Texas,33.61021105,-101.8205246,148631,152823,301454
48305,Lynn ,Texas,33.17683518,-101.8161233,2977,2831,5808
48307,McCulloch ,Texas,31.19887004,-99.3475465,4260,3838,8098
48309,McLennan ,Texas,31.55237627,-97.20177966,121359,127070,248429
48311,McMullen ,Texas,28.35268319,-98.56785422,387,275,662
48313,Madison ,Texas,30.96554203,-95.92842232,8127,6001,14128
48315,Marion ,Texas,32.79798609,-94.35717135,4915,5168,10083
48317,Martin ,Texas,32.30599109,-101.9512723,2934,2680,5614
48319,Mason ,Texas,30.71771247,-99.22614435,2146,2015,4161
48321,Matagorda ,Texas,28.82115928,-96.01099803,18319,18424,36743
48323,Maverick ,Texas,28.74246914,-100.3144814,28736,29234,57970
48325,Medina ,Texas,29.35569304,-99.11016729,25551,23783,49334
48327,Menard ,Texas,30.88981805,-99.82059985,1117,1006,2123
48329,Midland ,Texas,31.86913691,-102.0315952,82543,81651,164194
48331,Milam ,Texas,30.78633227,-96.9768059,12343,12321,24664
48333,Mills ,Texas,31.4951895,-98.59544037,2329,2573,4902
48335,Mitchell ,Texas,32.30620153,-100.9211385,5383,3175,8558
48337,Montague ,Texas,33.6756831,-97.72463972,9403,10006,19409
48339,Montgomery ,Texas,30.300193,-95.50300218,274604,279841,554445
48341,Moore ,Texas,35.83771455,-101.8929871,11438,10363,21801
48343,Morris ,Texas,33.11346808,-94.73263732,5981,6443,12424
48345,Motley ,Texas,34.07406325,-100.7798138,580,576,1156
48347,Nacogdoches ,Texas,31.61598401,-94.61586668,31365,34193,65558
48349,Navarro ,Texas,32.04692633,-96.47247526,23845,24738,48583
48351,Newton ,Texas,30.78625387,-93.74479548,7233,6824,14057
48353,Nolan ,Texas,32.30352363,-100.4059875,7669,7297,14966
48355,Nueces ,Texas,27.72553964,-97.61304231,178020,182466,360486
48357,Ochiltree ,Texas,36.27835758,-100.8156689,5230,5118,10348
48359,Oldham ,Texas,35.40504562,-102.6027667,1145,945,2090
48361,Orange ,Texas,30.1213047,-93.89388801,41630,42417,84047
48363,Palo Pinto ,Texas,32.75315273,-98.31301535,13987,14330,28317
48365,Panola ,Texas,32.16235499,-94.30558828,11498,11942,23440
48367,Parker ,Texas,32.77765374,-97.80506519,64448,65354,129802
48369,Parmer ,Texas,34.53007351,-102.7844736,5059,4793,9852
48371,Pecos ,Texas,30.78101027,-102.7235301,9010,6787,15797
48373,Polk ,Texas,30.79269158,-94.83004054,25878,21959,47837
48375,Potter ,Texas,35.40129099,-101.8939266,62295,58604,120899
48377,Presidio ,Texas,29.99975851,-104.2405136,3497,3626,7123
48379,Rains ,Texas,32.87034393,-95.79340117,5868,5605,11473
48381,Randall ,Texas,34.96587579,-101.8970485,65083,67392,132475
48383,Reagan ,Texas,31.36611329,-101.5230926,1951,1801,3752
48385,Real ,Texas,29.83178143,-99.82219945,1426,1963,3389
48387,Red River ,Texas,33.62074665,-95.05026589,5986,6289,12275
48389,Reeves ,Texas,31.3230271,-103.6929792,8689,6436,15125
48391,Refugio ,Texas,28.3252599,-97.16562506,3586,3650,7236
48393,Roberts ,Texas,35.8384243,-100.8135704,401,484,885
48395,Robertson ,Texas,31.02705403,-96.51279027,8296,8594,16890
48397,Rockwall ,Texas,32.89772963,-96.40778287,46167,47475,93642
48399,Runnels ,Texas,31.83111829,-99.97619278,5233,5077,10310
48401,Rusk ,Texas,32.10772339,-94.76187637,28379,25216,53595
48403,Sabine ,Texas,31.34322699,-93.85171825,5072,5386,10458
48405,San Augustine ,Texas,31.39421774,-94.16818653,4085,4242,8327
48407,San Jacinto ,Texas,30.57954902,-95.166933,13718,14101,27819
48409,San Patricio ,Texas,28.00914673,-97.51869289,33721,33325,67046
48411,San Saba ,Texas,31.15520132,-98.81758683,3073,2889,5962
48413,Schleicher ,Texas,30.89742112,-100.5383161,1542,1519,3061
48415,Scurry ,Texas,32.74628268,-100.9164295,9425,7814,17239
48417,Shackelford ,Texas,32.73594855,-99.35404646,1770,1541,3311
48419,Shelby ,Texas,31.7924183,-94.14495987,12572,12906,25478
48421,Sherman ,Texas,36.27772009,-101.8934361,1574,1484,3058
48423,Smith ,Texas,32.37503982,-95.26917607,108730,116285,225015
48425,Somervell ,Texas,32.22225654,-97.77435476,4192,4551,8743
48427,Starr ,Texas,26.56209694,-98.7386839,31073,32821,63894
48429,Stephens ,Texas,32.73587163,-98.83618396,4808,4564,9372
48431,Sterling ,Texas,31.82783193,-101.0500236,622,519,1141
48433,Stonewall ,Texas,33.17918976,-100.253364,730,655,1385
48435,Sutton ,Texas,30.49836828,-100.5381816,2116,1749,3865
48437,Swisher ,Texas,34.53039366,-101.7349941,4036,3448,7484
48439,Tarrant ,Texas,32.771561,-97.29122712,988765,1031212,2019977
48441,Taylor ,Texas,32.30144626,-99.89015137,66718,69630,136348
48443,Terrell ,Texas,30.22499992,-102.0764849,429,433,862
48445,Terry ,Texas,33.17380586,-102.3351616,6515,6100,12615
48447,Throckmorton ,Texas,33.17748703,-99.21234794,694,873,1567
48449,Titus ,Texas,33.21658117,-94.96568536,16046,16684,32730
48451,Tom Green ,Texas,31.40444975,-100.462146,58343,59123,117466
48453,Travis ,Texas,30.33468592,-97.78195326,607356,595810,1203166
48455,Trinity ,Texas,31.08883484,-95.13550103,7011,7558,14569
48457,Tyler ,Texas,30.7712352,-94.37659989,11738,9758,21496
48459,Upshur ,Texas,32.73627012,-94.94147642,20224,20545,40769
48461,Upton ,Texas,31.36880187,-102.0431399,1843,1791,3634
48463,Uvalde ,Texas,29.35730736,-99.76230118,13083,13926,27009
48465,Val Verde ,Texas,29.89294989,-101.1517378,24925,24102,49027
48467,Van Zandt ,Texas,32.56371228,-95.83650054,26619,27749,54368
48469,Victoria ,Texas,28.79635428,-96.97151983,44999,46971,91970
48471,Walker ,Texas,30.73903097,-95.57229674,41642,29897,71539
48473,Waller ,Texas,30.0108084,-95.98765023,24869,25118,49987
48475,Ward ,Texas,31.5094924,-103.1025014,5864,5722,11586
48477,Washington ,Texas,30.21452419,-96.40344082,17259,17537,34796
48479,Webb ,Texas,27.76111449,-99.33152013,132906,139147,272053
48481,Wharton ,Texas,29.27788175,-96.22209612,20395,21156,41551
48483,Wheeler ,Texas,35.4012129,-100.2697689,2844,2638,5482
48485,Wichita ,Texas,33.9879363,-98.70357145,68325,63493,131818
48487,Wilbarger ,Texas,34.08077323,-99.24099269,6347,6559,12906
48489,Willacy ,Texas,26.46964023,-97.6612119,11681,10073,21754
48491,Williamson ,Texas,30.64803316,-97.60075125,259443,267614,527057
48493,Wilson ,Texas,29.17400019,-98.08655364,24197,24001,48198
48495,Winkler ,Texas,31.85006061,-103.0483407,3977,3825,7802
48497,Wise ,Texas,33.21591299,-97.6544743,32424,32215,64639
48499,Wood ,Texas,32.78640577,-95.38207509,21807,22008,43815
48501,Yoakum ,Texas,33.17299442,-102.827783,4438,4133,8571
48503,Young ,Texas,33.17662269,-98.68773492,8930,9184,18114
48505,Zapata ,Texas,27.00077886,-99.16864637,7177,7192,14369
48507,Zavala ,Texas,28.86619482,-99.76054874,6208,5923,12131
49001,Beaver ,Utah,38.35700068,-113.2355203,3280,3163,6443
49003,Box Elder ,Utah,41.52101093,-113.0821204,26887,26114,53001
49005,Cache ,Utah,41.72243823,-111.7436261,61354,60982,122336
49007,Carbon ,Utah,39.64811524,-110.5887389,10055,10301,20356
49009,Daggett ,Utah,40.8872738,-109.5076341,359,253,612
49011,Davis ,Utah,40.99002487,-112.111454,171584,169037,340621
49013,Duchesne ,Utah,40.29822784,-110.4251678,10312,9907,20219
49015,Emery ,Utah,38.99673936,-110.7005984,5234,5014,10248
49017,Garfield ,Utah,37.85488872,-111.4431009,2594,2423,5017
49019,Grand ,Utah,38.98197302,-109.5698565,4779,4837,9616
49021,Iron ,Utah,37.85917722,-113.2895085,24834,24857,49691
49023,Juab ,Utah,39.70273276,-112.7848178,5590,5358,10948
49025,Kane ,Utah,37.28507093,-111.8878356,3693,3657,7350
49027,Millard ,Utah,39.07327014,-113.1005925,6545,6188,12733
49029,Morgan ,Utah,41.08931622,-111.5731525,5824,5567,11391
49031,Piute ,Utah,38.33665567,-112.1273224,1020,884,1904
49033,Rich ,Utah,41.63225555,-111.2444728,1152,1198,2350
49035,Salt Lake ,Utah,40.6673228,-111.9236005,562543,558262,1120805
49037,San Juan ,Utah,37.62602305,-109.804542,7670,7611,15281
49039,Sanpete ,Utah,39.37394967,-111.5762739,15412,13954,29366
49041,Sevier ,Utah,38.74777491,-111.8044662,10815,10303,21118
49043,Summit ,Utah,40.86822678,-110.9556955,20766,19745,40511
49045,Tooele ,Utah,40.44875492,-113.1310967,32871,32314,65185
49047,Uintah ,Utah,40.12475409,-109.5186376,18496,17827,36323
49049,Utah ,Utah,40.11991421,-111.6702723,298256,292184,590440
49051,Wasatch ,Utah,40.33078046,-111.1681534,15544,14979,30523
49053,Washington ,Utah,37.28037659,-113.5047693,79500,81037,160537
49055,Wayne ,Utah,38.32435306,-110.9038914,1397,1297,2694
49057,Weber ,Utah,41.26982203,-111.9133951,124402,123329,247731
50001,Addison ,Vermont,44.03090368,-73.14081599,18272,18667,36939
50003,Bennington ,Vermont,43.03542794,-73.09296956,17611,18309,35920
50005,Caledonia ,Vermont,44.46468704,-72.1022113,15218,15207,30425
50007,Chittenden ,Vermont,44.46100167,-73.08091306,79547,82505,162052
50009,Essex ,Vermont,44.72798413,-71.73623486,3135,3073,6208
50011,Franklin ,Vermont,44.85749429,-72.91200545,24357,24668,49025
50013,Grand Isle ,Vermont,44.79675861,-73.29485418,3476,3489,6965
50015,Lamoille ,Vermont,44.60574115,-72.64140295,12591,12677,25268
50017,Orange ,Vermont,44.00565784,-72.37680636,14357,14580,28937
50019,Orleans ,Vermont,44.82879693,-72.24375516,13525,13386,26911
50021,Rutland ,Vermont,43.58007563,-73.03661801,29079,30194,59273
50023,Washington ,Vermont,44.27344616,-72.61494553,28816,29661,58477
50025,Windham ,Vermont,42.99061051,-72.71379548,20937,22213,43150
50027,Windsor ,Vermont,43.58000424,-72.58621402,27052,28375,55427
51001,Accomack ,Virginia,37.76426023,-75.63327004,15861,16881,32742
51003,Albemarle ,Virginia,38.02287624,-78.55671571,50856,55499,106355
51005,Alleghany ,Virginia,37.78779618,-80.00623073,7520,7766,15286
51007,Amelia ,Virginia,37.33599547,-77.97613306,6652,6202,12854
51009,Amherst ,Virginia,37.60479925,-79.14514649,15358,16524,31882
51011,Appomattox ,Virginia,37.37227967,-78.81257926,7563,8014,15577
51013,Arlington ,Virginia,38.87856846,-77.10106876,115819,115984,231803
51015,Augusta ,Virginia,38.16444155,-79.13383485,37897,36804,74701
51017,Bath ,Virginia,38.05871253,-79.74106886,2310,2083,4393
51019,Bedford ,Virginia,37.31516949,-79.52418436,38306,39602,77908
51021,Bland ,Virginia,37.13398684,-81.13020783,3542,2905,6447
51023,Botetourt ,Virginia,37.55712164,-79.81233136,16388,16834,33222
51025,Brunswick ,Virginia,36.76477604,-77.85902364,8892,7773,16665
51027,Buchanan ,Virginia,37.26660954,-82.03601381,11155,10983,22138
51029,Buckingham ,Virginia,37.57217517,-78.52879421,9422,7582,17004
51031,Campbell ,Virginia,37.20534259,-79.0965555,26736,28434,55170
51033,Caroline ,Virginia,38.02673377,-77.34706624,15138,15046,30184
51035,Carroll ,Virginia,36.73157853,-80.73388376,14963,14775,29738
51036,Charles City ,Virginia,37.35671209,-77.06222021,3441,3554,6995
51037,Charlotte ,Virginia,37.01162024,-78.66164969,5981,6114,12095
51041,Chesterfield ,Virginia,37.37853715,-77.58694775,163534,175913,339447
51043,Clarke ,Virginia,39.11230575,-77.99668742,7333,7032,14365
51045,Craig ,Virginia,37.48168174,-80.21142471,2501,2612,5113
51047,Culpeper ,Virginia,38.48602902,-77.95583367,25249,25201,50450
51049,Cumberland ,Virginia,37.5121263,-78.24495055,4830,4956,9786
51051,Dickenson ,Virginia,37.12580814,-82.35037208,7585,7375,14960
51053,Dinwiddie ,Virginia,37.07593861,-77.63226901,14010,14298,28308
51057,Essex ,Virginia,37.94340645,-76.95144013,4962,6074,11036
51059,Fairfax ,Virginia,38.83683969,-77.27698787,566646,576883,1143529
51061,Fauquier ,Virginia,38.73864827,-77.8092385,34283,34832,69115
51063,Floyd ,Virginia,36.93162707,-80.36252486,7824,7842,15666
51065,Fluvanna ,Virginia,37.8418877,-78.27731313,12005,14277,26282
51067,Franklin ,Virginia,36.99195576,-79.88105915,27532,28701,56233
51069,Frederick ,Virginia,39.20457788,-78.26254727,42405,42748,85153
51071,Giles ,Virginia,37.31424646,-80.70293917,8252,8562,16814
51073,Gloucester ,Virginia,37.41596002,-76.54343568,18328,18833,37161
51075,Goochland ,Virginia,37.7217452,-77.91596085,11129,11353,22482
51077,Grayson ,Virginia,36.65655451,-81.2247751,7995,7816,15811
51079,Greene ,Virginia,38.29760056,-78.46688906,9450,9960,19410
51081,Greensville ,Virginia,36.67588778,-77.55958006,7336,4323,11659
51083,Halifax ,Virginia,36.76691788,-78.93663558,16638,18141,34779
51085,Hanover ,Virginia,37.76014472,-77.49117517,51222,53227,104449
51087,Henrico ,Virginia,37.53798526,-77.40582666,154247,171395,325642
51089,Henry ,Virginia,36.68277306,-79.87395941,24866,26722,51588
51091,Highland ,Virginia,38.36232105,-79.56855152,1043,1171,2214
51093,Isle of Wight ,Virginia,36.89128915,-76.72584445,17744,18628,36372
51095,James City ,Virginia,37.3287933,-76.7787722,35884,38269,74153
51097,King and Queen ,Virginia,37.71863567,-76.8952822,3538,3514,7052
51099,King George ,Virginia,38.27334741,-77.15719219,12996,12894,25890
51101,King William ,Virginia,37.7066094,-77.08855641,8113,8384,16497
51103,Lancaster ,Virginia,37.73453364,-76.46322992,5108,5696,10804
51105,Lee ,Virginia,36.70540303,-83.12857045,12608,11526,24134
51107,Loudoun ,Virginia,39.09065296,-77.63572109,190737,194406,385143
51109,Louisa ,Virginia,37.97819672,-77.96289166,17376,18004,35380
51111,Lunenburg ,Virginia,36.94621475,-78.24055151,6261,6017,12278
51113,Madison ,Virginia,38.41372171,-78.2792385,6350,6789,13139
51115,Mathews ,Virginia,37.43539057,-76.34364807,4292,4504,8796
51117,Mecklenburg ,Virginia,36.68035568,-78.36274507,14909,15938,30847
51119,Middlesex ,Virginia,37.63027567,-76.56974806,5182,5518,10700
51121,Montgomery ,Virginia,37.17428754,-80.38720608,50738,47259,97997
51125,Nelson ,Virginia,37.78736112,-78.88683962,7198,7614,14812
51127,New Kent ,Virginia,37.50521357,-76.99734976,10603,10500,21103
51131,Northampton ,Virginia,37.34298527,-75.87697256,5699,6258,11957
51133,Northumberland ,Virginia,37.88761804,-76.41965245,5967,6256,12223
51135,Nottoway ,Virginia,37.14303067,-78.05124836,8403,7097,15500
51137,Orange ,Virginia,38.24620055,-78.01368499,17418,18194,35612
51139,Page ,Virginia,38.61943693,-78.48438942,11675,12074,23749
51141,Patrick ,Virginia,36.67831207,-80.28439518,8896,8963,17859
51143,Pittsylvania ,Virginia,36.82123908,-79.39713017,30241,31435,61676
51145,Powhatan ,Virginia,37.55018051,-77.91521122,15249,13325,28574
51147,Prince Edward ,Virginia,37.22428691,-78.44107072,11493,11463,22956
51149,Prince George ,Virginia,37.18651752,-77.22417011,20612,17282,37894
51153,Prince William ,Virginia,38.70300344,-77.48085392,227951,228798,456749
51155,Pulaski ,Virginia,37.06355071,-80.71439511,17138,17096,34234
51157,Rappahannock ,Virginia,38.68479034,-78.15923215,3630,3702,7332
51159,Richmond ,Virginia,37.94339257,-76.72687604,4928,3950,8878
51161,Roanoke ,Virginia,37.26928425,-80.06799368,44850,48733,93583
51163,Rockbridge ,Virginia,37.81452202,-79.44727341,11185,11324,22509
51165,Rockingham ,Virginia,38.5120314,-78.87575803,38910,40534,79444
51167,Russell ,Virginia,36.93385794,-82.09537329,13371,14037,27408
51169,Scott ,Virginia,36.71428216,-82.60294511,11089,10920,22009
51171,Shenandoah ,Virginia,38.85832798,-78.57083917,21044,22001,43045
51173,Smyth ,Virginia,36.84375252,-81.53697384,15301,15758,31059
51175,Southampton ,Virginia,36.72042727,-77.10609937,9345,8594,17939
51177,Spotsylvania ,Virginia,38.18495992,-77.65607305,64570,66842,131412
51179,Stafford ,Virginia,38.42070638,-77.458009,72540,71472,144012
51181,Surry ,Virginia,37.10983819,-76.90019956,3203,3397,6600
51183,Sussex ,Virginia,36.9217768,-77.26181124,6831,4655,11486
51185,Tazewell ,Virginia,37.1249544,-81.56059234,20841,21239,42080
51187,Warren ,Virginia,38.90865481,-78.20846331,19666,19783,39449
51191,Washington ,Virginia,36.72444527,-81.95982646,26851,27555,54406
51193,Westmoreland ,Virginia,38.11193561,-76.80417126,8629,9009,17638
51195,Wise ,Virginia,36.97524043,-82.62119834,20490,18535,39025
51197,Wythe ,Virginia,36.91710398,-81.07871224,14112,14828,28940
51199,York ,Virginia,37.24316539,-76.56356736,33231,34356,67587
51510,Alexandria city,Virginia,38.81849826,-77.08611547,75346,81159,156505
51520,Bristol city,Virginia,36.61793605,-82.16070796,8004,8839,16843
51530,Buena Vista city,Virginia,37.73189522,-79.35685968,2845,3554,6399
51540,Charlottesville city,Virginia,38.03749162,-78.48551533,22830,24212,47042
51550,Chesapeake city,Virginia,36.67779366,-76.30238059,116188,121632,237820
51570,Colonial Heights city,Virginia,37.26500314,-77.39689492,8053,9540,17593
51580,Covington city,Virginia,37.7785436,-79.98678203,2742,2840,5582
51590,Danville city,Virginia,36.58307906,-79.40875276,19041,22471,41512
51595,Emporia city,Virginia,36.69534402,-77.53558947,2408,2973,5381
51600,Fairfax city,Virginia,38.85308551,-77.29973008,11801,12064,23865
51610,Falls Church city,Virginia,38.88468273,-77.17510934,7017,7050,14067
51620,Franklin city,Virginia,36.68308445,-76.93861443,3611,4600,8211
51630,Fredericksburg city,Virginia,38.29920619,-77.4871913,13064,15405,28469
51640,Galax city,Virginia,36.66600996,-80.9176019,3174,3464,6638
51650,Hampton city,Virginia,37.05508914,-76.36291888,65275,70308,135583
51660,Harrisonburg city,Virginia,38.43620525,-78.8734531,25580,27811,53391
51670,Hopewell city,Virginia,37.29147996,-77.29852872,10375,12033,22408
51678,Lexington city,Virginia,37.78250625,-79.44398355,3910,3200,7110
51680,Lynchburg city,Virginia,37.40027527,-79.19086206,37515,42616,80131
51683,Manassas city,Virginia,38.74792464,-77.48384977,20775,20682,41457
51685,Manassas Park city,Virginia,38.77183472,-77.44499005,8568,7855,16423
51690,Martinsville city,Virginia,36.68265221,-79.86362137,5867,7234,13101
51700,Newport News city,Virginia,37.10514982,-76.5184856,87221,92924,180145
51710,Norfolk city,Virginia,36.89452164,-76.25901677,128293,117299,245592
51720,Norton city,Virginia,36.93141576,-82.62624386,1792,2198,3990
51730,Petersburg city,Virginia,37.20429554,-77.39129856,14651,17176,31827
51735,Poquoson city,Virginia,37.13178477,-76.35687106,5856,6183,12039
51740,Portsmouth city,Virginia,36.84683892,-76.35404273,45919,49392,95311
51750,Radford city,Virginia,37.12289586,-80.55874698,8425,9205,17630
51760,Richmond city,Virginia,37.5294662,-77.47556118,106222,117565,223787
51770,Roanoke city,Virginia,37.27848613,-79.95803917,47775,51846,99621
51775,Salem city,Virginia,37.28642266,-80.05546176,11902,13617,25519
51790,Staunton city,Virginia,38.15929242,-79.06113615,11198,13254,24452
51800,Suffolk city,Virginia,36.69531812,-76.639839,43085,46075,89160
51810,Virginia Beach city,Virginia,36.73353798,-76.04348548,221285,228850,450135
51820,Waynesboro city,Virginia,38.06741066,-78.90135567,10660,11266,21926
51830,Williamsburg city,Virginia,37.2692447,-76.70761651,6727,8061,14788
51840,Winchester city,Virginia,39.17351342,-78.17461171,13573,14216,27789
53001,Adams ,Washington,46.98338234,-118.5605804,9844,9608,19452
53003,Asotin ,Washington,46.19182075,-117.2030335,10721,11616,22337
53005,Benton ,Washington,46.23980805,-119.5112177,97139,97029,194168
53007,Chelan ,Washington,47.86922061,-120.6189727,37764,37993,75757
53009,Clallam ,Washington,48.04932237,-123.9279974,36857,37630,74487
53011,Clark ,Washington,45.77920928,-122.48252,230092,235292,465384
53013,Columbia ,Washington,46.29752641,-117.9077748,1930,2071,4001
53015,Cowlitz ,Washington,46.19324155,-122.6810024,51937,53175,105112
53017,Douglas ,Washington,47.73610352,-119.6917882,20821,20550,41371
53019,Ferry ,Washington,48.47028892,-118.5165891,3884,3692,7576
53021,Franklin ,Washington,46.53472741,-118.8989693,47145,43515,90660
53023,Garfield ,Washington,46.43163892,-117.5451673,1099,1125,2224
53025,Grant ,Washington,47.20568101,-119.4517521,48099,46761,94860
53027,Grays Harbor ,Washington,47.15024549,-123.7735063,36981,34986,71967
53029,Island ,Washington,48.16300543,-122.548071,40781,40855,81636
53031,Jefferson ,Washington,47.74888658,-123.5952649,15354,15502,30856
53033,King ,Washington,47.49024908,-121.8052337,1082940,1080317,2163257
53035,Kitsap ,Washington,47.61316507,-122.671723,134094,128381,262475
53037,Kittitas ,Washington,47.12439985,-120.6798778,22555,22270,44825
53039,Klickitat ,Washington,45.87379704,-120.7891208,10751,10645,21396
53041,Lewis ,Washington,46.57777294,-122.3926829,38509,38438,76947
53043,Lincoln ,Washington,47.57626322,-118.4187272,5311,5124,10435
53045,Mason ,Washington,47.34839444,-123.1927241,32413,30214,62627
53047,Okanogan ,Washington,48.54879406,-119.740838,21061,20577,41638
53049,Pacific ,Washington,46.55569078,-123.7041285,10640,10641,21281
53051,Pend Oreille ,Washington,48.53229305,-117.2739951,6694,6525,13219
53053,Pierce ,Washington,47.0240903,-122.104557,427571,432269,859840
53055,San Juan ,Washington,48.57819131,-122.9649694,7956,8517,16473
53057,Skagit ,Washington,48.47937123,-121.7301803,61376,62531,123907
53059,Skamania ,Washington,46.02303608,-121.9147438,5861,5759,11620
53061,Snohomish ,Washington,48.04747504,-121.6974941,394526,392094,786620
53063,Spokane ,Washington,47.62066276,-117.404035,246906,250969,497875
53065,Stevens ,Washington,48.39909982,-117.8551606,21944,22270,44214
53067,Thurston ,Washington,46.925772,-122.8331861,134402,140282,274684
53069,Wahkiakum ,Washington,46.29176918,-123.4244202,2000,2189,4189
53071,Walla Walla ,Washington,46.22977316,-118.4784405,30830,29406,60236
53073,Whatcom ,Washington,48.82590865,-121.719892,107228,109584,216812
53075,Whitman ,Washington,46.90117314,-117.5230271,24749,23844,48593
53077,Yakima ,Washington,46.45706868,-120.7384563,124900,124425,249325
54001,Barbour ,West Virginia,39.13295009,-80.00301852,8143,8587,16730
54003,Berkeley ,West Virginia,39.46406576,-78.02751273,56013,57482,113495
54005,Boone ,West Virginia,38.02298972,-81.71120724,11350,11467,22817
54007,Braxton ,West Virginia,38.6998546,-80.71925219,7125,7157,14282
54009,Brooke ,West Virginia,40.27386887,-80.57645213,11171,11601,22772
54011,Cabell ,West Virginia,38.42030495,-82.24171158,46739,48579,95318
54013,Calhoun ,West Virginia,38.84453227,-81.1175781,3642,3754,7396
54015,Clay ,West Virginia,38.4625231,-81.0750742,4388,4397,8785
54017,Doddridge ,West Virginia,39.26917419,-80.70697158,4692,3844,8536
54019,Fayette ,West Virginia,38.02877295,-81.08115812,22099,22027,44126
54021,Gilmer ,West Virginia,38.92404872,-80.85705728,4733,3472,8205
54023,Grant ,West Virginia,39.10514419,-79.19558583,5813,5828,11641
54025,Greenbrier ,West Virginia,37.94692633,-80.45298795,17203,18144,35347
54027,Hampshire ,West Virginia,39.31707446,-78.61411363,11980,11383,23363
54029,Hancock ,West Virginia,40.52186153,-80.57389981,14376,15304,29680
54031,Hardy ,West Virginia,39.00753469,-78.85794895,7112,6730,13842
54033,Harrison ,West Virginia,39.28353096,-80.37985599,33301,34908,68209
54035,Jackson ,West Virginia,38.83448426,-81.6748025,14417,14601,29018
54037,Jefferson ,West Virginia,39.3075778,-77.86279699,27743,28436,56179
54039,Kanawha ,West Virginia,38.33656864,-81.52809332,89483,96227,185710
54041,Lewis ,West Virginia,38.99586655,-80.50217411,8202,8074,16276
54043,Lincoln ,West Virginia,38.17534901,-82.07039116,10539,10539,21078
54045,Logan ,West Virginia,37.83153304,-81.93533023,16672,17129,33801
54047,McDowell ,West Virginia,37.37845591,-81.65360621,9837,9380,19217
54049,Marion ,West Virginia,39.51000058,-80.24338858,27819,28678,56497
54051,Marshall ,West Virginia,39.86059886,-80.66340417,15730,15915,31645
54053,Mason ,West Virginia,38.76972107,-82.02656337,13026,13913,26939
54055,Mercer ,West Virginia,37.40551198,-81.11143791,28728,31758,60486
54057,Mineral ,West Virginia,39.41467204,-78.94381937,13649,13629,27278
54059,Mingo ,West Virginia,37.72641677,-82.13469117,12024,12717,24741
54061,Monongalia ,West Virginia,39.63032135,-80.04655651,54501,50751,105252
54063,Monroe ,West Virginia,37.56038408,-80.55049862,6683,6784,13467
54065,Morgan ,West Virginia,39.56044006,-78.257795,8763,8861,17624
54067,Nicholas ,West Virginia,38.29169364,-80.79934458,12420,12904,25324
54069,Ohio ,West Virginia,40.09694845,-80.61891678,20465,22082,42547
54071,Pendleton ,West Virginia,38.68074812,-79.35089253,3622,3434,7056
54073,Pleasants ,West Virginia,39.37095425,-81.16060932,4064,3443,7507
54075,Pocahontas ,West Virginia,38.33179862,-80.007782,4377,4154,8531
54077,Preston ,West Virginia,39.46932615,-79.66816177,17408,16429,33837
54079,Putnam ,West Virginia,38.50861837,-81.90899114,27862,28790,56652
54081,Raleigh ,West Virginia,37.77135893,-81.24865058,38188,38044,76232
54083,Randolph ,West Virginia,38.77475362,-79.87578836,14861,14204,29065
54085,Ritchie ,West Virginia,39.17825796,-81.06297956,4965,4967,9932
54087,Roane ,West Virginia,38.71402337,-81.34835068,7034,7171,14205
54089,Summers ,West Virginia,37.65585567,-80.85856068,5994,7024,13018
54091,Taylor ,West Virginia,39.33598008,-80.04618854,8580,8371,16951
54093,Tucker ,West Virginia,39.11359283,-79.56498524,3540,3487,7027
54095,Tyler ,West Virginia,39.46527551,-80.88483879,4437,4472,8909
54097,Upshur ,West Virginia,38.89784446,-80.23344086,12200,12405,24605
54099,Wayne ,West Virginia,38.14594655,-82.42696105,19835,20873,40708
54101,Webster ,West Virginia,38.49470203,-80.42186956,4199,4319,8518
54103,Wetzel ,West Virginia,39.60528121,-80.63911411,7586,8028,15614
54105,Wirt ,West Virginia,39.02244687,-81.37868925,2922,2875,5797
54107,Wood ,West Virginia,39.2111652,-81.51503289,41246,44310,85556
54109,Wyoming ,West Virginia,37.60960861,-81.5491961,10695,11016,21711
55001,Adams ,Wisconsin,43.96953352,-89.77038801,10783,9290,20073
55003,Ashland ,Wisconsin,46.31608492,-90.67794383,7930,7782,15712
55005,Barron ,Wisconsin,45.42368241,-91.84830961,22616,22636,45252
55007,Bayfield ,Wisconsin,46.52376232,-91.20078816,7632,7360,14992
55009,Brown ,Wisconsin,44.45294304,-88.00373327,128824,130962,259786
55011,Buffalo ,Wisconsin,44.37983087,-91.7544548,6658,6509,13167
55013,Burnett ,Wisconsin,45.86266969,-92.36757937,7832,7426,15258
55015,Calumet ,Wisconsin,44.08160414,-88.21805755,24954,24853,49807
55017,Chippewa ,Wisconsin,45.06940795,-91.27984423,33078,30557,63635
55019,Clark ,Wisconsin,44.73473713,-90.61207331,17478,17013,34491
55021,Columbia ,Wisconsin,43.46663551,-89.33373881,29047,27907,56954
55023,Crawford ,Wisconsin,43.2394704,-90.93104339,8490,7798,16288
55025,Dane ,Wisconsin,43.06730937,-89.41814359,263322,266521,529843
55027,Dodge ,Wisconsin,43.41629511,-88.70752142,45777,41999,87776
55029,Door ,Wisconsin,44.9473,-87.31350352,13535,13904,27439
55031,Douglas ,Wisconsin,46.4328746,-91.91616249,21757,21645,43402
55033,Dunn ,Wisconsin,44.94656071,-91.89641428,22372,22126,44498
55035,Eau Claire ,Wisconsin,44.72678038,-91.28598003,50874,52117,102991
55037,Florence ,Wisconsin,45.84846007,-88.39809982,2275,2062,4337
55039,Fond du Lac ,Wisconsin,43.75358405,-88.48825558,50302,52013,102315
55041,Forest ,Wisconsin,45.66734375,-88.77042824,4541,4477,9018
55043,Grant ,Wisconsin,42.86747934,-90.70620464,26920,24908,51828
55045,Green ,Wisconsin,42.67997955,-89.60221001,18230,18634,36864
55047,Green Lake ,Wisconsin,43.80040174,-89.04486894,9437,9320,18757
55049,Iowa ,Wisconsin,43.00047854,-90.13537425,11892,11728,23620
55051,Iron ,Wisconsin,46.26226573,-90.24206341,2915,2800,5715
55053,Jackson ,Wisconsin,44.31916668,-90.8052477,10955,9551,20506
55055,Jefferson ,Wisconsin,43.02082847,-88.77588315,42343,42309,84652
55057,Juneau ,Wisconsin,43.92459315,-90.11377206,14067,12352,26419
55059,Kenosha ,Wisconsin,42.57692389,-88.04236244,83312,85018,168330
55061,Kewaunee ,Wisconsin,44.51607781,-87.61528359,10279,10081,20360
55063,La Crosse ,Wisconsin,43.90657568,-91.1152154,57361,60489,117850
55065,Lafayette ,Wisconsin,42.66048836,-90.13169965,8443,8292,16735
55067,Langlade ,Wisconsin,45.26234865,-89.07193258,9721,9443,19164
55069,Lincoln ,Wisconsin,45.33743735,-89.73459922,13999,13849,27848
55071,Manitowoc ,Wisconsin,44.1199269,-87.80966932,39451,39956,79407
55073,Marathon ,Wisconsin,44.89829553,-89.75908861,67976,67288,135264
55075,Marinette ,Wisconsin,45.3829227,-88.03328216,20375,20162,40537
55077,Marquette ,Wisconsin,43.81955996,-89.39872545,7746,7461,15207
55078,Menominee ,Wisconsin,45.00437743,-88.71004163,2324,2255,4579
55079,Milwaukee ,Wisconsin,43.00719657,-87.9667718,461670,492539,954209
55081,Monroe ,Wisconsin,43.94574599,-90.61779584,23019,22483,45502
55083,Oconto ,Wisconsin,45.02617321,-88.26921837,19187,18369,37556
55085,Oneida ,Wisconsin,45.70555559,-89.52180829,17724,17621,35345
55087,Outagamie ,Wisconsin,44.41609216,-88.46494825,92241,92513,184754
55089,Ozaukee ,Wisconsin,43.38403073,-87.95090548,43342,44942,88284
55091,Pepin ,Wisconsin,44.58291952,-92.00153218,3696,3566,7262
55093,Pierce ,Wisconsin,44.71963001,-92.4224127,20641,20962,41603
55095,Polk ,Wisconsin,45.46141826,-92.44134465,21842,21507,43349
55097,Portage ,Wisconsin,44.47603877,-89.50139676,35508,35091,70599
55099,Price ,Wisconsin,45.68039334,-90.36139954,6813,6677,13490
55101,Racine ,Wisconsin,42.7474547,-88.06121441,96702,98696,195398
55103,Richland ,Wisconsin,43.37563473,-90.42948052,8834,8705,17539
55105,Rock ,Wisconsin,42.67122924,-89.07157743,79654,82115,161769
55107,Rusk ,Wisconsin,45.475143,-91.13316555,7109,7074,14183
55109,St. Croix ,Wisconsin,45.03407067,-92.45279638,43899,44018,87917
55111,Sauk ,Wisconsin,43.42666627,-89.94822348,31747,31849,63596
55113,Sawyer ,Wisconsin,45.87997677,-91.14454391,8339,8031,16370
55115,Shawano ,Wisconsin,44.78915,-88.76540956,20521,20488,41009
55117,Sheboygan ,Wisconsin,43.72117335,-87.94536569,57922,57283,115205
55119,Taylor ,Wisconsin,45.21159345,-90.50123901,10385,9971,20356
55121,Trempealeau ,Wisconsin,44.30396634,-91.35845638,14932,14506,29438
55123,Vernon ,Wisconsin,43.59387226,-90.83441066,15302,15214,30516
55125,Vilas ,Wisconsin,46.05290699,-89.51483954,10931,10662,21593
55127,Walworth ,Wisconsin,42.66849109,-88.54193618,51374,51639,103013
55129,Washburn ,Wisconsin,45.89922934,-91.79122078,7771,7918,15689
55131,Washington ,Wisconsin,43.3684752,-88.23072509,66754,67781,134535
55133,Waukesha ,Wisconsin,43.01822209,-88.30451376,196103,202776,398879
55135,Waupaca ,Wisconsin,44.47048886,-88.96478759,26297,25147,51444
55137,Waushara ,Wisconsin,44.11312968,-89.24289699,12641,11475,24116
55139,Winnebago ,Wisconsin,44.06888991,-88.64464869,85597,84329,169926
55141,Wood ,Wisconsin,44.45533661,-90.04156869,36056,37218,73274
56001,Albany ,Wyoming,41.65452908,-105.7238158,19916,18186,38102
56003,Big Horn ,Wyoming,44.52669011,-107.9951832,6033,5868,11901
56005,Campbell ,Wyoming,44.24818848,-105.5482083,24559,23149,47708
56007,Carbon ,Wyoming,41.69435955,-106.930667,8332,7145,15477
56009,Converse ,Wyoming,42.97233569,-105.507158,7206,6791,13997
56011,Crook ,Wyoming,44.58850478,-104.5699359,3730,3680,7410
56013,Fremont ,Wyoming,43.04054626,-108.6304584,20135,19941,40076
56015,Goshen ,Wyoming,42.08791523,-104.3533123,6948,6490,13438
56017,Hot Springs ,Wyoming,43.71895325,-108.4421551,2387,2293,4680
56019,Johnson ,Wyoming,44.03879909,-106.5846732,4477,4038,8515
56021,Laramie ,Wyoming,41.30694427,-104.6894919,49460,48232,97692
56023,Lincoln ,Wyoming,42.2639124,-110.6559917,9695,9316,19011
56025,Natrona ,Wyoming,42.96206494,-106.7985,40816,39794,80610
56027,Niobrara ,Wyoming,43.05644088,-104.4754172,1088,1360,2448
56029,Park ,Wyoming,44.52046482,-109.5879214,14276,14845,29121
56031,Platte ,Wyoming,42.13295483,-104.9659338,4499,4174,8673
56033,Sheridan ,Wyoming,44.78997491,-106.8792685,14852,15160,30012
56035,Sublette ,Wyoming,42.76689863,-109.9147097,5367,4584,9951
56037,Sweetwater ,Wyoming,41.65953369,-108.8795629,22882,21235,44117
56039,Teton ,Wyoming,43.93465071,-110.5898176,11911,11148,23059
56041,Uinta ,Wyoming,41.28764212,-110.5476278,10505,10104,20609
56043,Washakie ,Wyoming,43.90496993,-107.6828187,4137,3992,8129
56045,Weston ,Wyoming,43.8404101,-104.567658,3768,3332,7100
